"","sub","cond","item","seq","start_time","end_time","duration_ms","task"
"10",1,1,27,1,1171301,1175080,3779,"reading"
"11",1,1,8,2,1178076,1181947,3871,"reading"
"13",1,1,2,3,1187445,1190664,3219,"reading"
"15",1,1,17,4,1199796,1205081,5285,"reading"
"16",1,1,12,5,1207689,1210814,3125,"reading"
"18",1,1,6,6,1259369,1261768,2399,"reading"
"20",1,1,23,7,1267603,1270051,2448,"reading"
"21",1,1,20,8,1272855,1275835,2980,"reading"
"22",1,1,15,9,1279455,1283419,3964,"reading"
"23",1,1,14,10,1285222,1288236,3014,"reading"
"24",1,1,19,11,1290137,1293703,3566,"reading"
"25",1,1,16,12,1297607,1301053,3446,"reading"
"26",1,1,28,13,1305879,1308870,2991,"reading"
"27",1,1,24,14,1310666,1314520,3854,"reading"
"28",1,1,4,15,1318616,1322537,3921,"reading"
"30",1,1,5,16,1327295,1330054,2759,"reading"
"32",1,1,10,17,1335739,1337920,2181,"reading"
"34",1,1,25,18,1342010,1344288,2278,"reading"
"35",1,1,7,19,1346146,1349721,3575,"reading"
"37",1,1,30,20,1354476,1357922,3446,"reading"
"38",1,1,22,21,1361507,1364505,2998,"reading"
"39",1,1,21,22,1367041,1370239,3198,"reading"
"40",1,1,29,23,1372768,1375889,3121,"reading"
"41",1,1,3,24,1378545,1380655,2110,"reading"
"43",1,1,13,25,1385202,1388172,2970,"reading"
"44",1,1,1,26,1390064,1393239,3175,"reading"
"46",1,1,26,27,1398140,1401023,2883,"reading"
"47",1,1,18,28,1403401,1406490,3089,"reading"
"48",1,1,9,29,1408296,1411490,3194,"reading"
"50",1,1,11,30,1416222,1419107,2885,"reading"
"52",1,2,31,31,1424107,1428440,4333,"reading"
"54",1,2,32,32,1433188,1436674,3486,"reading"
"56",1,2,33,33,1441835,1445691,3856,"reading"
"58",1,2,55,34,1449801,1452108,2307,"reading"
"59",1,3,74,35,1455835,1460225,4390,"reading"
"60",1,2,43,36,1464092,1467692,3600,"reading"
"61",1,3,69,37,1469877,1473659,3782,"reading"
"63",1,2,60,38,1479250,1483492,4242,"reading"
"64",1,3,80,39,1488408,1494159,5751,"reading"
"65",1,2,50,40,1496282,1501209,4927,"reading"
"66",1,2,42,41,1505383,1509444,4061,"reading"
"68",1,3,71,42,1598838,1602429,3591,"reading"
"70",1,2,34,43,1609342,1611880,2538,"reading"
"72",1,3,67,44,1620170,1623180,3010,"reading"
"74",1,3,68,45,1661468,1664933,3465,"reading"
"76",1,2,59,46,1674203,1676266,2063,"reading"
"77",1,3,79,47,1700873,1703718,2845,"reading"
"78",1,2,45,48,1705803,1708485,2682,"reading"
"79",1,3,72,49,1710242,1713268,3026,"reading"
"81",1,3,64,50,1717921,1720635,2714,"reading"
"83",1,2,44,51,1725203,1727252,2049,"reading"
"84",1,2,47,52,1729038,1734252,5214,"reading"
"85",1,3,63,53,1736454,1739786,3332,"reading"
"87",1,3,77,54,1744368,1746453,2085,"reading"
"88",1,3,75,55,1748663,1752703,4040,"reading"
"89",1,3,82,56,1756973,1760653,3680,"reading"
"90",1,3,84,57,1763936,1766103,2167,"reading"
"91",1,3,85,58,1769416,1773871,4455,"reading"
"92",1,2,41,59,1831282,1833939,2657,"reading"
"94",1,3,90,60,1837900,1841039,3139,"reading"
"95",1,3,78,61,1843046,1847806,4760,"reading"
"96",1,3,83,62,1849711,1851673,1962,"reading"
"97",1,3,89,63,1853537,1856323,2786,"reading"
"98",1,2,54,64,1858067,1860540,2473,"reading"
"99",1,2,57,65,1863274,1866357,3083,"reading"
"100",1,3,66,66,1868146,1870524,2378,"reading"
"102",1,2,56,67,1875103,1877524,2421,"reading"
"103",1,2,36,68,1879119,1881524,2405,"reading"
"105",1,2,51,69,1885995,1889408,3413,"reading"
"106",1,2,48,70,1891114,1894058,2944,"reading"
"107",1,2,37,71,1896876,1899091,2215,"reading"
"109",1,2,39,72,1903446,1905975,2529,"reading"
"111",1,3,88,73,1911326,1914325,2999,"reading"
"112",1,2,58,74,1916366,1919509,3143,"reading"
"113",1,2,40,75,1921426,1924025,2599,"reading"
"115",1,2,38,76,1928718,1931942,3224,"reading"
"117",1,2,49,77,1936276,1938926,2650,"reading"
"118",1,3,86,78,1940692,1944310,3618,"reading"
"119",1,2,46,79,1946262,1949626,3364,"reading"
"120",1,3,81,80,1951679,1955010,3331,"reading"
"121",1,3,87,81,1956977,1959477,2500,"reading"
"122",1,3,73,82,1961245,1964310,3065,"reading"
"123",1,3,61,83,1966197,1969127,2930,"reading"
"125",1,3,76,84,1973982,1976044,2062,"reading"
"126",1,2,52,85,1978935,1981594,2659,"reading"
"127",1,2,35,86,1983468,1986178,2710,"reading"
"129",1,2,53,87,1990464,1993194,2730,"reading"
"130",1,3,70,88,1996391,1999262,2871,"reading"
"132",1,3,62,89,2004494,2006895,2401,"reading"
"134",1,3,65,90,2011824,2014362,2538,"reading"
"145",1,1,92,91,2142630,2146150,3520,"zString"
"147",1,1,116,92,2151223,2154267,3044,"zString"
"148",1,1,111,93,2156409,2158950,2541,"zString"
"149",1,1,94,94,2162542,2165100,2558,"zString"
"151",1,1,118,95,2170106,2173501,3395,"zString"
"152",1,1,102,96,2175754,2177868,2114,"zString"
"154",1,1,115,97,2183355,2185918,2563,"zString"
"155",1,1,100,98,2188629,2191735,3106,"zString"
"157",1,1,119,99,2197123,2201135,4012,"zString"
"158",1,1,97,100,2203629,2205685,2056,"zString"
"160",1,1,106,101,2210466,2213485,3019,"zString"
"161",1,1,91,102,2218492,2221686,3194,"zString"
"163",1,1,98,103,2258026,2260371,2345,"zString"
"165",1,1,109,104,2265361,2267121,1760,"zString"
"166",1,1,93,105,2269379,2272037,2658,"zString"
"168",1,1,99,106,2278984,2281505,2521,"zString"
"170",1,1,114,107,2289065,2291855,2790,"zString"
"171",1,1,120,108,2294371,2297455,3084,"zString"
"172",1,1,95,109,2301261,2305622,4361,"zString"
"174",1,1,105,110,2310809,2313139,2330,"zString"
"175",1,1,104,111,2315254,2318805,3551,"zString"
"176",1,1,108,112,2321051,2323722,2671,"zString"
"177",1,1,113,113,2326129,2328539,2410,"zString"
"178",1,1,101,114,2331786,2334656,2870,"zString"
"180",1,1,96,115,2367493,2370376,2883,"zString"
"182",1,1,103,116,2375416,2379193,3777,"zString"
"183",1,1,110,117,2382519,2384976,2457,"zString"
"184",1,1,112,118,2391254,2394577,3323,"zString"
"185",1,1,117,119,2441095,2443378,2283,"zString"
"186",1,1,107,120,2446444,2449112,2668,"zString"
"187",1,2,121,121,2451432,2453979,2547,"zString"
"189",1,2,122,122,2458269,2461262,2993,"zString"
"191",1,2,123,123,2466724,2469579,2855,"zString"
"193",1,2,125,124,2475059,2478946,3887,"zString"
"195",1,2,128,125,2528865,2534098,5233,"zString"
"197",1,3,154,126,2542009,2545515,3506,"zString"
"199",1,3,178,127,2550079,2552532,2453,"zString"
"200",1,2,126,128,2554946,2558232,3286,"zString"
"202",1,3,179,129,2564018,2567417,3399,"zString"
"203",1,2,145,130,2569683,2572733,3050,"zString"
"204",1,3,159,131,2575694,2578967,3273,"zString"
"206",1,3,165,132,2627214,2630235,3021,"zString"
"207",1,3,153,133,2632738,2635285,2547,"zString"
"209",1,2,150,134,2640642,2643218,2576,"zString"
"210",1,3,168,135,2645634,2648568,2934,"zString"
"211",1,3,156,136,2652102,2655668,3566,"zString"
"213",1,3,157,137,2661106,2664237,3131,"zString"
"215",1,2,132,138,2668764,2671906,3142,"zString"
"217",1,3,172,139,2676863,2680986,4123,"zString"
"218",1,3,152,140,2685355,2688804,3449,"zString"
"220",1,3,175,141,2693333,2696757,3424,"zString"
"221",1,2,138,142,2699173,2701687,2514,"zString"
"222",1,3,171,143,2705282,2708271,2989,"zString"
"223",1,2,149,144,2710564,2712971,2407,"zString"
"224",1,2,146,145,2715731,2719037,3306,"zString"
"225",1,2,141,146,2721763,2724371,2608,"zString"
"226",1,2,140,147,2727175,2730638,3463,"zString"
"227",1,2,136,148,2732682,2736088,3406,"zString"
"228",1,3,151,149,2739325,2742422,3097,"zString"
"230",1,3,170,150,2748018,2751955,3937,"zString"
"231",1,3,163,151,2755693,2758606,2913,"zString"
"232",1,2,139,152,2764627,2767773,3146,"zString"
"233",1,2,144,153,2815953,2818924,2971,"zString"
"234",1,2,131,154,2821509,2824291,2782,"zString"
"236",1,2,129,155,2833214,2837008,3794,"zString"
"238",1,3,158,156,2844889,2848725,3836,"zString"
"240",1,3,167,157,2859513,2864892,5379,"zString"
"241",1,3,164,158,2871923,2876393,4470,"zString"
"242",1,3,162,159,2895475,2898260,2785,"zString"
"244",1,2,124,160,2904152,2907294,3142,"zString"
"246",1,3,155,161,2912736,2916677,3941,"zString"
"248",1,3,161,162,2921465,2924428,2963,"zString"
"250",1,3,166,163,2928374,2930995,2621,"zString"
"251",1,2,133,164,2933440,2936579,3139,"zString"
"252",1,3,177,165,2939794,2942462,2668,"zString"
"253",1,2,137,166,2945145,2947929,2784,"zString"
"254",1,2,147,167,2951104,2954645,3541,"zString"
"255",1,2,127,168,2957521,2961362,3841,"zString"
"257",1,2,134,169,2966363,2969246,2883,"zString"
"258",1,2,143,170,2972447,2976463,4016,"zString"
"259",1,2,130,171,2979137,2982630,3493,"zString"
"261",1,3,174,172,2988415,2991647,3232,"zString"
"262",1,3,176,173,2994449,2998231,3782,"zString"
"263",1,2,135,174,3002957,3007364,4407,"zString"
"264",1,2,142,175,3010014,3013747,3733,"zString"
"265",1,3,173,176,3017108,3019865,2757,"zString"
"266",1,2,148,177,3024350,3029165,4815,"zString"
"267",1,3,180,178,3031984,3036765,4781,"zString"
"268",1,3,169,179,3039347,3042965,3618,"zString"
"269",1,3,160,180,3048263,3052199,3936,"zString"
"1010",2,1,69,1,4643350,4649336,5986,"zString"
"12",2,1,79,2,4655558,4661687,6129,"zString"
"136",2,1,65,3,4664726,4671537,6811,"zString"
"156",2,1,77,4,4676235,4681521,5286,"zString"
"1610",2,1,80,5,4684535,4692988,8453,"zString"
"17",2,1,63,6,4696114,4702388,6274,"zString"
"19",2,1,67,7,4707558,4714322,6764,"zString"
"2110",2,1,64,8,4719447,4727389,7942,"zString"
"2310",2,1,71,9,4732180,4738339,6159,"zString"
"256",2,1,89,10,4742836,4748757,5921,"zString"
"2610",2,1,73,11,4755316,4759390,4074,"zString"
"271",2,1,70,12,4761640,4768407,6767,"zString"
"29",2,1,87,13,4774354,4780574,6220,"zString"
"301",2,1,78,14,4784242,4791008,6766,"zString"
"31",2,1,84,15,4794623,4800325,5702,"zString"
"321",2,1,66,16,4802440,4809175,6735,"zString"
"341",2,1,62,17,4816204,4822759,6555,"zString"
"36",2,1,83,18,4826954,4834293,7339,"zString"
"371",2,1,61,19,4836168,4843727,7559,"zString"
"391",2,1,90,20,4851701,4856710,5009,"zString"
"401",2,1,85,21,4858971,4864677,5706,"zString"
"411",2,1,88,22,4868781,4876277,7496,"zString"
"42",2,1,74,23,4879567,4886411,6844,"zString"
"431",2,1,82,24,4888839,4894178,5339,"zString"
"441",2,1,68,25,4896786,4906012,9226,"zString"
"461",2,1,81,26,4912380,4918279,5899,"zString"
"471",2,1,76,27,4920277,4927096,6819,"zString"
"481",2,1,75,28,4929621,4936263,6642,"zString"
"49",2,1,72,29,4940221,4948330,8109,"zString"
"51",2,1,86,30,4953487,4959814,6327,"zString"
"521",2,2,1,31,4962340,4967997,5657,"zString"
"541",2,2,2,32,4972985,4978581,5596,"zString"
"561",2,2,3,33,4984262,4990432,6170,"zString"
"581",2,3,38,34,4996020,5002348,6328,"zString"
"601",2,2,10,35,5008509,5013616,5107,"zString"
"62",2,3,57,36,5019873,5027016,7143,"zString"
"631",2,2,14,37,5028824,5034083,5259,"zString"
"641",2,2,13,38,5035963,5040950,4987,"zString"
"651",2,3,49,39,5043811,5048884,5073,"zString"
"661",2,3,31,40,5052458,5060101,7643,"zString"
"681",2,2,12,41,5065624,5072034,6410,"zString"
"701",2,2,19,42,5143825,5148456,4631,"zString"
"71",2,2,27,43,5150300,5156256,5956,"zString"
"721",2,3,51,44,5158257,5165224,6967,"zString"
"73",2,2,18,45,5167819,5173924,6105,"zString"
"741",2,3,32,46,5176931,5182991,6060,"zString"
"761",2,3,37,47,5188179,5193175,4996,"zString"
"781",2,2,24,48,5199493,5205475,5982,"zString"
"791",2,2,28,49,5207499,5213976,6477,"zString"
"80",2,3,52,50,5217002,5223009,6007,"zString"
"811",2,3,36,51,5226493,5233242,6749,"zString"
"831",2,2,26,52,5239014,5245010,5996,"zString"
"841",2,3,54,53,5246823,5252243,5420,"zString"
"851",2,3,41,54,5257457,5261544,4087,"zString"
"871",2,2,4,55,5267520,5274277,6757,"zString"
"891",2,2,22,56,5280481,5286328,5847,"zString"
"901",2,3,46,57,5289002,5294344,5342,"zString"
"911",2,2,23,58,5297120,5303712,6592,"zString"
"921",2,3,60,59,5308289,5314379,6090,"zString"
"93",2,3,35,60,5317220,5322029,4809,"zString"
"951",2,3,58,61,5326807,5331729,4922,"zString"
"961",2,2,30,62,5336621,5342030,5409,"zString"
"971",2,2,29,63,5344310,5348380,4070,"zString"
"981",2,3,47,64,5351371,5357781,6410,"zString"
"991",2,3,56,65,5360499,5365747,5248,"zString"
"1001",2,3,45,66,5367970,5372681,4711,"zString"
"101",2,3,48,67,5375260,5380581,5321,"zString"
"1021",2,2,7,68,5385512,5392181,6669,"zString"
"104",2,3,40,69,5397252,5402415,5163,"zString"
"1061",2,2,5,70,5408205,5412232,4027,"zString"
"108",2,3,55,71,5417036,5421599,4563,"zString"
"1091",2,2,16,72,5424566,5429533,4967,"zString"
"110",2,2,21,73,5431572,5436083,4511,"zString"
"1111",2,3,39,74,5438824,5444300,5476,"zString"
"1131",2,2,11,75,5449120,5454467,5347,"zString"
"1151",2,3,53,76,5459326,5463884,4558,"zString"
"116",2,3,42,77,5466402,5471034,4632,"zString"
"1181",2,3,43,78,5477721,5482718,4997,"zString"
"1191",2,2,15,79,5484840,5490151,5311,"zString"
"1201",2,2,9,80,5492371,5496818,4447,"zString"
"1221",2,3,50,81,5501970,5508602,6632,"zString"
"1231",2,3,34,82,5511272,5518019,6747,"zString"
"1251",2,2,20,83,5523099,5528269,5170,"zString"
"1261",2,3,44,84,5532172,5538286,6114,"zString"
"1271",2,3,59,85,5540651,5547286,6635,"zString"
"128",2,2,17,86,5550769,5557037,6268,"zString"
"1291",2,2,8,87,5559196,5565604,6408,"zString"
"131",2,2,6,88,5571678,5577254,5576,"zString"
"133",2,3,33,89,5582507,5588238,5731,"zString"
"135",2,2,25,90,5593562,5598438,4876,"zString"
"1451",2,1,158,91,5707238,5712675,5437,"reading"
"1471",2,1,155,92,5719592,5725843,6251,"reading"
"1491",2,1,151,93,5733080,5739811,6731,"reading"
"1511",2,1,156,94,5746389,5750510,4121,"reading"
"153",2,1,160,95,5755867,5759911,4044,"reading"
"1551",2,1,161,96,5765051,5770177,5126,"reading"
"1571",2,1,166,97,5775992,5781378,5386,"reading"
"1581",2,1,152,98,5784413,5790461,6048,"reading"
"1601",2,1,172,99,5798660,5802728,4068,"reading"
"1611",2,1,178,100,5806717,5812162,5445,"reading"
"162",2,1,154,101,5814146,5818829,4683,"reading"
"164",2,1,179,102,5824062,5827979,3917,"reading"
"1651",2,1,180,103,5832035,5838046,6011,"reading"
"1661",2,1,170,104,5843722,5849297,5575,"reading"
"167",2,1,169,105,5853066,5861231,8165,"reading"
"1681",2,1,163,106,5863830,5868997,5167,"reading"
"169",2,1,162,107,5872175,5876431,4256,"reading"
"1711",2,1,168,108,5881840,5888698,6858,"reading"
"1721",2,1,164,109,5891708,5897282,5574,"reading"
"173",2,1,171,110,5899473,5904849,5376,"reading"
"1741",2,1,176,111,5906816,5912166,5350,"reading"
"1751",2,1,165,112,5914534,5920882,6348,"reading"
"1761",2,1,174,113,5923319,5928966,5647,"reading"
"1771",2,1,157,114,5932847,5938283,5436,"reading"
"179",2,1,175,115,5945668,5949167,3499,"reading"
"1801",2,1,177,116,5952105,5957701,5596,"reading"
"181",2,1,159,117,5960727,5966467,5740,"reading"
"1831",2,1,167,118,5973367,5978635,5268,"reading"
"1841",2,1,173,119,5982083,5986551,4468,"reading"
"1851",2,1,153,120,5991159,5996402,5243,"reading"
"1871",2,2,91,121,6002474,6008102,5628,"reading"
"1891",2,2,92,122,6014735,6019420,4685,"reading"
"1911",2,2,93,123,6027465,6031070,3605,"reading"
"1931",2,3,126,124,6036940,6041987,5047,"reading"
"1951",2,3,149,125,6047134,6052104,4970,"reading"
"196",2,2,113,126,6055028,6060437,5409,"reading"
"1971",2,3,141,127,6062701,6067671,4970,"reading"
"198",2,2,119,128,6069926,6075688,5762,"reading"
"1991",2,2,120,129,6078104,6083022,4918,"reading"
"2001",2,3,137,130,6085250,6091339,6089,"reading"
"201",2,3,138,131,6093892,6097889,3997,"reading"
"2021",2,3,128,132,6123620,6130209,6589,"reading"
"2041",2,2,111,133,6139076,6143743,4667,"reading"
"205",2,3,148,134,6146135,6151943,5808,"reading"
"2061",2,3,142,135,6154481,6160126,5645,"reading"
"2071",2,2,107,136,6162525,6166910,4385,"reading"
"208",2,3,135,137,6171018,6176094,5076,"reading"
"2091",2,2,118,138,6178804,6183411,4607,"reading"
"2101",2,3,139,139,6187478,6191128,3650,"reading"
"2111",2,2,116,140,6194316,6198861,4545,"reading"
"212",2,2,98,141,6201083,6206228,5145,"reading"
"214",2,2,99,142,6211065,6216929,5864,"reading"
"216",2,2,104,143,6223983,6229462,5479,"reading"
"2171",2,3,147,144,6232574,6240246,7672,"reading"
"2181",2,3,150,145,6242262,6248963,6701,"reading"
"219",2,3,122,146,6251454,6258163,6709,"reading"
"2211",2,3,123,147,6267549,6273581,6032,"reading"
"2231",2,3,140,148,6279823,6286914,7091,"reading"
"2241",2,2,117,149,6291611,6296931,5320,"reading"
"2251",2,3,131,150,6299107,6305465,6358,"reading"
"2271",2,3,130,151,6311321,6316682,5361,"reading"
"229",2,3,143,152,6321754,6328215,6461,"reading"
"2301",2,3,133,153,6332266,6338217,5951,"reading"
"2311",2,2,109,154,6340194,6344300,4106,"reading"
"2321",2,3,136,155,6346460,6350966,4506,"reading"
"2331",2,3,124,156,6353448,6357950,4502,"reading"
"235",2,3,146,157,6365505,6370817,5312,"reading"
"2361",2,2,115,158,6376655,6380984,4329,"reading"
"237",2,2,96,159,6385828,6390485,4657,"reading"
"239",2,2,94,160,6395825,6400551,4726,"reading"
"2411",2,2,102,161,6405442,6409452,4010,"reading"
"243",2,2,110,162,6416835,6420736,3901,"reading"
"2441",2,2,108,163,6427570,6432086,4516,"reading"
"245",2,3,125,164,6434863,6440420,5557,"reading"
"247",2,2,95,165,6446919,6452053,5134,"reading"
"249",2,3,145,166,6458579,6462787,4208,"reading"
"2501",2,3,121,167,6465549,6470488,4939,"reading"
"2521",2,2,112,168,6476293,6482688,6395,"reading"
"2531",2,3,144,169,6484570,6490071,5501,"reading"
"2541",2,2,114,170,6491969,6497421,5452,"reading"
"2551",2,3,132,171,6500489,6504489,4000,"reading"
"2571",2,2,105,172,6509332,6512789,3457,"reading"
"2581",2,3,129,173,6515545,6519839,4294,"reading"
"260",2,2,97,174,6525494,6529256,3762,"reading"
"2621",2,2,101,175,6534974,6539373,4399,"reading"
"2641",2,3,127,176,6547829,6553307,5478,"reading"
"2661",2,2,103,177,6560774,6564973,4199,"reading"
"2671",2,3,134,178,6570809,6576158,5349,"reading"
"2681",2,2,106,179,6579010,6582891,3881,"reading"
"2691",2,2,100,180,6584939,6589308,4369,"reading"
"1011",3,2,61,1,1647937,1652599,4662,"reading"
"1210",3,2,62,2,1657462,1661783,4321,"reading"
"14",3,2,63,3,1667047,1671033,3986,"reading"
"1612",3,3,11,4,1678252,1682467,4215,"reading"
"188",3,3,25,5,1687835,1691968,4133,"reading"
"194",3,2,68,6,1693522,1700935,7413,"reading"
"2112",3,3,5,7,1706480,1709785,3305,"reading"
"2312",3,3,29,8,1715041,1719085,4044,"reading"
"2410",3,2,65,9,1720716,1726169,5453,"reading"
"2611",3,3,26,10,1732760,1737535,4775,"reading"
"272",3,2,75,11,1739137,1743969,4832,"reading"
"281",3,2,82,12,1745364,1749419,4055,"reading"
"291",3,2,88,13,1751403,1755586,4183,"reading"
"302",3,2,81,14,1757120,1761453,4333,"reading"
"311",3,3,22,15,1763428,1767803,4375,"reading"
"322",3,2,76,16,1769833,1772837,3004,"reading"
"33",3,3,16,17,1774417,1780087,5670,"reading"
"342",3,3,2,18,1782044,1785871,3827,"reading"
"361",3,2,78,19,1791652,1796904,5252,"reading"
"372",3,2,71,20,1798320,1802487,4167,"reading"
"392",3,3,6,21,1808198,1811938,3740,"reading"
"412",3,2,85,22,1817564,1824772,7208,"reading"
"421",3,3,30,23,1826353,1831789,5436,"reading"
"432",3,2,80,24,1833239,1837422,4183,"reading"
"442",3,3,15,25,1838692,1842189,3497,"reading"
"45",3,3,4,26,1844021,1848356,4335,"reading"
"472",3,2,66,27,1854059,1857523,3464,"reading"
"491",3,3,27,28,1862796,1867540,4744,"reading"
"501",3,2,89,29,1869091,1873473,4382,"reading"
"511",3,3,9,30,1875321,1878991,3670,"reading"
"53",3,3,24,31,1886213,1889874,3661,"reading"
"542",3,3,8,32,1891441,1895924,4483,"reading"
"562",3,3,21,33,1903114,1907575,4461,"reading"
"57",3,2,90,34,1909279,1913008,3729,"reading"
"582",3,3,14,35,1914509,1919075,4566,"reading"
"591",3,3,19,36,1920618,1925075,4457,"reading"
"602",3,2,84,37,1926550,1930759,4209,"reading"
"611",3,3,28,38,1932112,1935609,3497,"reading"
"621",3,2,73,39,1937290,1941243,3953,"reading"
"632",3,3,12,40,1942527,1946610,4083,"reading"
"652",3,3,23,41,1952613,1956927,4314,"reading"
"662",3,3,17,42,2012746,2018263,5517,"reading"
"67",3,3,18,43,2019679,2023764,4085,"reading"
"682",3,2,79,44,2025428,2029064,3636,"reading"
"69",3,2,69,45,2030578,2034197,3619,"reading"
"711",3,3,3,46,2040151,2043814,3663,"reading"
"731",3,2,83,47,2048781,2052098,3317,"reading"
"742",3,2,77,48,2053461,2057431,3970,"reading"
"75",3,2,70,49,2059025,2063831,4806,"reading"
"771",3,3,10,50,2070156,2073649,3493,"reading"
"792",3,3,13,51,2080263,2083865,3602,"reading"
"801",3,2,67,52,2085309,2089216,3907,"reading"
"82",3,2,74,53,2096029,2100516,4487,"reading"
"832",3,2,64,54,2101921,2105916,3995,"reading"
"852",3,3,7,55,2111924,2116533,4609,"reading"
"872",3,2,72,56,2123386,2127017,3631,"reading"
"892",3,3,1,57,2132306,2136717,4411,"reading"
"912",3,3,20,58,2141495,2145317,3822,"reading"
"922",3,2,86,59,2146862,2151484,4622,"reading"
"931",3,2,87,60,2152893,2158118,5225,"reading"
"941",3,1,47,61,2159798,2164752,4954,"reading"
"952",3,1,51,62,2166004,2170935,4931,"reading"
"962",3,1,50,63,2172536,2177386,4850,"reading"
"972",3,1,60,64,2179168,2182736,3568,"reading"
"982",3,1,42,65,2184163,2188253,4090,"reading"
"1002",3,1,36,66,2193701,2197203,3502,"reading"
"1022",3,1,37,67,2202536,2206220,3684,"reading"
"1041",3,1,38,68,2213031,2217337,4306,"reading"
"1062",3,1,59,69,2222408,2225454,3046,"reading"
"1071",3,1,57,70,2226892,2231471,4579,"reading"
"1081",3,1,39,71,2233108,2237121,4013,"reading"
"1101",3,1,35,72,2244301,2247838,3537,"reading"
"1121",3,1,43,73,2253557,2258522,4965,"reading"
"1132",3,1,48,74,2259971,2265505,5534,"reading"
"114",3,1,58,75,2267293,2272305,5012,"reading"
"1152",3,1,56,76,2274197,2279755,5558,"reading"
"1161",3,1,41,77,2281549,2284273,2724,"reading"
"1182",3,1,40,78,2289560,2293956,4396,"reading"
"1202",3,1,33,79,2300393,2304957,4564,"reading"
"1222",3,1,32,80,2311097,2314474,3377,"reading"
"124",3,1,53,81,2321300,2325640,4340,"reading"
"1252",3,1,55,82,2326949,2331541,4592,"reading"
"1262",3,1,44,83,2333089,2336658,3569,"reading"
"1272",3,1,52,84,2338004,2341708,3704,"reading"
"1281",3,1,34,85,2343087,2347275,4188,"reading"
"1301",3,1,31,86,2353373,2357191,3818,"reading"
"1321",3,1,49,87,2365137,2368792,3655,"reading"
"1331",3,1,45,88,2370589,2373826,3237,"reading"
"1341",3,1,54,89,2375279,2378359,3080,"reading"
"1351",3,1,46,90,2379744,2383092,3348,"reading"
"1452",3,2,151,91,2531248,2535798,4550,"zString"
"1472",3,2,152,92,2539673,2543798,4125,"zString"
"1492",3,2,153,93,2547917,2550898,2981,"zString"
"1512",3,2,169,94,2554424,2559132,4708,"zString"
"1521",3,3,91,95,2560531,2564165,3634,"zString"
"1541",3,2,178,96,2568572,2571616,3044,"zString"
"1552",3,2,159,97,2573066,2577116,4050,"zString"
"1572",3,3,102,98,2581100,2583332,2232,"zString"
"159",3,2,161,99,2587478,2590500,3022,"zString"
"1613",3,2,170,100,2595426,2597967,2541,"zString"
"1621",3,2,180,101,2599535,2611084,11549,"zString"
"1631",3,3,117,102,2612719,2615300,2581,"zString"
"1641",3,2,158,103,2617470,2622201,4731,"zString"
"1662",3,3,116,104,2626252,2630268,4016,"zString"
"1671",3,3,101,105,2631710,2635201,3491,"zString"
"1691",3,2,157,106,2639974,2642985,3011,"zString"
"1712",3,2,163,107,2648887,2652452,3565,"zString"
"1722",3,3,119,108,2655156,2658835,3679,"zString"
"1731",3,3,118,109,2660241,2662735,2494,"zString"
"1742",3,2,179,110,2664207,2669302,5095,"zString"
"1752",3,3,114,111,2671082,2673419,2337,"zString"
"1762",3,3,99,112,2675089,2678853,3764,"zString"
"1781",3,2,165,113,2683561,2686620,3059,"zString"
"1791",3,3,113,114,2688260,2690636,2376,"zString"
"1802",3,3,100,115,2692460,2696637,4177,"zString"
"1821",3,3,111,116,2700601,2703904,3303,"zString"
"1832",3,2,174,117,2705935,2710353,4418,"zString"
"1842",3,3,94,118,2711994,2713737,1743,"zString"
"1861",3,2,172,119,2717636,2721087,3451,"zString"
"1872",3,2,155,120,2722842,2725621,2779,"zString"
"1892",3,3,109,121,2730535,2732471,1936,"zString"
"190",3,2,166,122,2734685,2737387,2702,"zString"
"1912",3,3,115,123,2739077,2741222,2145,"zString"
"192",3,2,173,124,2742730,2745722,2992,"zString"
"1932",3,3,96,125,2747492,2750688,3196,"zString"
"1952",3,3,92,126,2754877,2758272,3395,"zString"
"1972",3,3,110,127,2762203,2764873,2670,"zString"
"1981",3,2,162,128,2766422,2769756,3334,"zString"
"2002",3,2,156,129,2774416,2777973,3557,"zString"
"2022",3,3,93,130,2781839,2784906,3067,"zString"
"2042",3,2,168,131,2789187,2792673,3486,"zString"
"2051",3,2,176,132,2878036,2882229,4193,"zString"
"2062",3,2,177,133,2884282,2887263,2981,"zString"
"2072",3,3,106,134,2889242,2892796,3554,"zString"
"2081",3,3,97,135,2894131,2896013,1882,"zString"
"2102",3,3,95,136,2900653,2903413,2760,"zString"
"2121",3,3,98,137,2907865,2911547,3682,"zString"
"2141",3,3,112,138,2915912,2919113,3201,"zString"
"2151",3,3,120,139,2920757,2925297,4540,"zString"
"2161",3,2,164,140,2926728,2930881,4153,"zString"
"2172",3,3,104,141,2933165,2936781,3616,"zString"
"2182",3,3,107,142,2938349,2941598,3249,"zString"
"2191",3,3,103,143,2943538,2946998,3460,"zString"
"2201",3,3,105,144,2949069,2952398,3329,"zString"
"2212",3,3,108,145,2954191,2957565,3374,"zString"
"2221",3,2,154,146,2959141,2962600,3459,"zString"
"2242",3,2,167,147,2967735,2970966,3231,"zString"
"2252",3,2,160,148,2972475,2975732,3257,"zString"
"2272",3,2,175,149,2979554,2982966,3412,"zString"
"2281",3,2,171,150,2985109,2988833,3724,"zString"
"2291",3,1,128,151,2990796,2993866,3070,"zString"
"2313",3,1,121,152,2998684,3001383,2699,"zString"
"2332",3,1,138,153,3005154,3008033,2879,"zString"
"2341",3,1,139,154,3009689,3013184,3495,"zString"
"2351",3,1,149,155,3015135,3018468,3333,"zString"
"2362",3,1,136,156,3020099,3024067,3968,"zString"
"2371",3,1,123,157,3026616,3030101,3485,"zString"
"2391",3,1,125,158,3034525,3038851,4326,"zString"
"2412",3,1,129,159,3043397,3047801,4404,"zString"
"2431",3,1,146,160,3052671,3055569,2898,"zString"
"2442",3,1,137,161,3057379,3060369,2990,"zString"
"2451",3,1,141,162,3062143,3064869,2726,"zString"
"2461",3,1,135,163,3066386,3069835,3449,"zString"
"2471",3,1,140,164,3071804,3075369,3565,"zString"
"2481",3,1,131,165,3077038,3080552,3514,"zString"
"2502",3,1,147,166,3085797,3089553,3756,"zString"
"2511",3,1,142,167,3091068,3094920,3852,"zString"
"2522",3,1,130,168,3096949,3099986,3037,"zString"
"2542",3,1,150,169,3104468,3107537,3069,"zString"
"2552",3,1,133,170,3109367,3112203,2836,"zString"
"2561",3,1,145,171,3113964,3117404,3440,"zString"
"2572",3,1,124,172,3118926,3123571,4645,"zString"
"2591",3,1,143,173,3128974,3134121,5147,"zString"
"2601",3,1,122,174,3135959,3139938,3979,"zString"
"2622",3,1,132,175,3144033,3147605,3572,"zString"
"2642",3,1,134,176,3151564,3154988,3424,"zString"
"2651",3,1,127,177,3156501,3160522,4021,"zString"
"2672",3,1,126,178,3164776,3167972,3196,"zString"
"2692",3,1,144,179,3173467,3176956,3489,"zString"
"270",3,1,148,180,3178292,3182606,4314,"zString"
"1012",4,2,31,1,5152662,5157616,4954,"zString"
"1211",4,2,32,2,5161487,5166464,4977,"zString"
"141",4,2,33,3,5170422,5172364,1942,"zString"
"1614",4,2,49,4,5176986,5179465,2479,"zString"
"1710",4,2,56,5,5181442,5184849,3407,"zString"
"1810",4,3,70,6,5186654,5191448,4794,"zString"
"2010",4,3,83,7,5196850,5205365,8515,"zString"
"2113",4,3,80,8,5206825,5211632,4807,"zString"
"2210",4,2,53,9,5213281,5216716,3435,"zString"
"2314",4,2,37,10,5218245,5221666,3421,"zString"
"2510",4,3,82,11,5226755,5231216,4461,"zString"
"2612",4,2,48,12,5232727,5237700,4973,"zString"
"273",4,3,89,13,5239340,5241583,2243,"zString"
"282",4,3,86,14,5243598,5246217,2619,"zString"
"292",4,2,51,15,5247986,5251167,3181,"zString"
"303",4,3,88,16,5252882,5256201,3319,"zString"
"312",4,2,59,17,5258976,5262518,3542,"zString"
"323",4,3,72,18,5264029,5267050,3021,"zString"
"343",4,2,45,19,5272748,5275434,2686,"zString"
"351",4,3,87,20,5277287,5281651,4364,"zString"
"362",4,2,50,21,5283310,5286519,3209,"zString"
"373",4,3,71,22,5287927,5294152,6225,"zString"
"393",4,2,55,23,5298712,5302969,4257,"zString"
"402",4,2,58,24,5307113,5311552,4439,"zString"
"413",4,3,77,25,5313445,5316036,2591,"zString"
"422",4,2,35,26,5317935,5321053,3118,"zString"
"443",4,2,41,27,5327098,5331786,4688,"zString"
"462",4,3,62,28,5336141,5340387,4246,"zString"
"482",4,3,85,29,5343940,5348470,4530,"zString"
"492",4,3,74,30,5350246,5354021,3775,"zString"
"502",4,3,68,31,5357211,5365771,8560,"zString"
"522",4,2,38,32,5369847,5374405,4558,"zString"
"543",4,2,36,33,5378314,5381938,3624,"zString"
"563",4,2,44,34,5385294,5388555,3261,"zString"
"571",4,3,63,35,5390086,5396372,6286,"zString"
"592",4,3,76,36,5404356,5407709,3353,"zString"
"603",4,2,43,37,5409666,5412739,3073,"zString"
"612",4,2,39,38,5414812,5418389,3577,"zString"
"633",4,3,65,39,5424114,5429240,5126,"zString"
"653",4,3,66,40,5434258,5436890,2632,"zString"
"671",4,3,84,41,5442116,5444957,2841,"zString"
"683",4,2,34,42,5483919,5487842,3923,"zString"
"702",4,3,64,43,5491961,5496192,4231,"zString"
"722",4,2,46,44,5500548,5503692,3144,"zString"
"732",4,3,78,45,5505448,5508743,3295,"zString"
"743",4,3,81,46,5510430,5514943,4513,"zString"
"751",4,2,60,47,5516317,5519309,2992,"zString"
"762",4,3,75,48,5520851,5524528,3677,"zString"
"772",4,2,40,49,5527235,5530827,3592,"zString"
"793",4,3,69,50,5534998,5539277,4279,"zString"
"812",4,2,54,51,5544474,5549344,4870,"zString"
"821",4,3,67,52,5551036,5553943,2907,"zString"
"842",4,2,42,53,5558781,5562294,3513,"zString"
"86",4,3,73,54,5565772,5569779,4007,"zString"
"873",4,3,90,55,5571738,5575345,3607,"zString"
"881",4,2,57,56,5577089,5579912,2823,"zString"
"893",4,3,79,57,5581739,5584979,3240,"zString"
"902",4,3,61,58,5586674,5590045,3371,"zString"
"923",4,2,52,59,5595548,5598796,3248,"zString"
"932",4,2,47,60,5602719,5608146,5427,"zString"
"942",4,1,23,61,5610201,5612846,2645,"zString"
"953",4,1,12,62,5614331,5616613,2282,"zString"
"973",4,1,28,63,5620945,5624013,3068,"zString"
"983",4,1,6,64,5626154,5628963,2809,"zString"
"1003",4,1,8,65,5633290,5636415,3125,"zString"
"1023",4,1,30,66,5640358,5643614,3256,"zString"
"1031",4,1,3,67,5645371,5649347,3976,"zString"
"1051",4,1,17,68,5653125,5656114,2989,"zString"
"1063",4,1,29,69,5657606,5660434,2828,"zString"
"1072",4,1,18,70,5662492,5664698,2206,"zString"
"1082",4,1,19,71,5666976,5669715,2739,"zString"
"1092",4,1,16,72,5671136,5674898,3762,"zString"
"1102",4,1,20,73,5677179,5681732,4553,"zString"
"1112",4,1,24,74,5684068,5687349,3281,"zString"
"1122",4,1,13,75,5689183,5691982,2799,"zString"
"1133",4,1,9,76,5693613,5695332,1719,"zString"
"1153",4,1,4,77,5699514,5702083,2569,"zString"
"1171",4,1,2,78,5705921,5708816,2895,"zString"
"1192",4,1,25,79,5713871,5715966,2095,"zString"
"1203",4,1,15,80,5717703,5720616,2913,"zString"
"1212",4,1,27,81,5722298,5725467,3169,"zString"
"1223",4,1,5,82,5726897,5729434,2537,"zString"
"1241",4,1,11,83,5733636,5736434,2798,"zString"
"1263",4,1,1,84,5740999,5744751,3752,"zString"
"1282",4,1,21,85,5752733,5758018,5285,"zString"
"1292",4,1,14,86,5760342,5765234,4892,"zString"
"1302",4,1,10,87,5768757,5774537,5780,"zString"
"1322",4,1,26,88,5778060,5782386,4326,"zString"
"1332",4,1,7,89,5784551,5788252,3701,"zString"
"1352",4,1,22,90,5793317,5797986,4669,"zString"
"1453",4,2,121,91,5880244,5885789,5545,"reading"
"1473",4,2,122,92,5891478,5894323,2845,"reading"
"1493",4,2,123,93,5899163,5901572,2409,"reading"
"1513",4,3,157,94,5905692,5908823,3131,"reading"
"1531",4,3,155,95,5913911,5917740,3829,"reading"
"1553",4,3,180,96,5922398,5925140,2742,"reading"
"1561",4,3,173,97,5926703,5929807,3104,"reading"
"1573",4,3,154,98,5931422,5934324,2902,"reading"
"1591",4,3,169,99,5938305,5940874,2569,"reading"
"1602",4,3,176,100,5942440,5945624,3184,"reading"
"1615",4,2,148,101,5948181,5952758,4577,"reading"
"1622",4,3,152,102,5954437,5958308,3871,"reading"
"1642",4,3,156,103,5963355,5966742,3387,"reading"
"1663",4,2,124,104,5972267,5975009,2742,"reading"
"1682",4,2,143,105,5979512,5982042,2530,"reading"
"1692",4,2,145,106,5983557,5985575,2018,"reading"
"1701",4,2,131,107,5987297,5989743,2446,"reading"
"1723",4,2,136,108,5995908,5998526,2618,"reading"
"1732",4,2,125,109,6000340,6002526,2186,"reading"
"1753",4,3,163,110,6006629,6009893,3264,"reading"
"1763",4,2,140,111,6011484,6015145,3661,"reading"
"1772",4,3,160,112,6016756,6019910,3154,"reading"
"1792",4,2,138,113,6024759,6029277,4518,"reading"
"1803",4,3,177,114,6031342,6035810,4468,"reading"
"1811",4,2,146,115,6038240,6042744,4504,"reading"
"1822",4,2,128,116,6044927,6048178,3251,"reading"
"1843",4,2,150,117,6052981,6055862,2881,"reading"
"1852",4,2,127,118,6057336,6059145,1809,"reading"
"1873",4,2,135,119,6063555,6065512,1957,"reading"
"1881",4,3,151,120,6067350,6069412,2062,"reading"
"1901",4,3,175,121,6074863,6077162,2299,"reading"
"1913",4,2,142,122,6080328,6083596,3268,"reading"
"1921",4,3,179,123,6085233,6087579,2346,"reading"
"1933",4,2,132,124,6089406,6091762,2356,"reading"
"1953",4,3,172,125,6096842,6098796,1954,"reading"
"1961",4,3,170,126,6103875,6109679,5804,"reading"
"1973",4,3,161,127,6111368,6115464,4096,"reading"
"1992",4,2,133,128,6122634,6127330,4696,"reading"
"2003",4,2,144,129,6128819,6132847,4028,"reading"
"2011",4,2,129,130,6134420,6139080,4660,"reading"
"2031",4,2,149,131,6143019,6147648,4629,"reading"
"2043",4,2,134,132,6169588,6172765,3177,"reading"
"2052",4,3,162,133,6174570,6179249,4679,"reading"
"2073",4,3,165,134,6184614,6187432,2818,"reading"
"2082",4,3,166,135,6189044,6191466,2422,"reading"
"2092",4,3,167,136,6195419,6198832,3413,"reading"
"2103",4,3,158,137,6200474,6203266,2792,"reading"
"2122",4,2,126,138,6209209,6212400,3191,"reading"
"2142",4,3,153,139,6216626,6222100,5474,"reading"
"2162",4,2,137,140,6227016,6232133,5117,"reading"
"2173",4,3,174,141,6234633,6240551,5918,"reading"
"2183",4,2,139,142,6242276,6245851,3575,"reading"
"2192",4,2,147,143,6247237,6250535,3298,"reading"
"2202",4,2,141,144,6252181,6255651,3470,"reading"
"2213",4,2,130,145,6257505,6260785,3280,"reading"
"2232",4,3,171,146,6264857,6266968,2111,"reading"
"2243",4,3,178,147,6268484,6271236,2752,"reading"
"2253",4,3,164,148,6273056,6277369,4313,"reading"
"2261",4,3,159,149,6279100,6281453,2353,"reading"
"2282",4,3,168,150,6286372,6289652,3280,"reading"
"2292",4,1,101,151,6290939,6292953,2014,"reading"
"2315",4,1,113,152,6297648,6300970,3322,"reading"
"2322",4,1,114,153,6302324,6304589,2265,"reading"
"2333",4,1,118,154,6306065,6308137,2072,"reading"
"2342",4,1,91,155,6310085,6312320,2235,"reading"
"2363",4,1,98,156,6318468,6320621,2153,"reading"
"2381",4,1,92,157,6326435,6329820,3385,"reading"
"2401",4,1,111,158,6334338,6338503,4165,"reading"
"2413",4,1,104,159,6340012,6342704,2692,"reading"
"2421",4,1,105,160,6343997,6346688,2691,"reading"
"2432",4,1,110,161,6347995,6351371,3376,"reading"
"2443",4,1,109,162,6353570,6358255,4685,"reading"
"2452",4,1,108,163,6359985,6363572,3587,"reading"
"2462",4,1,99,164,6364932,6368122,3190,"reading"
"2482",4,1,107,165,6374184,6376389,2205,"reading"
"2491",4,1,95,166,6377785,6379556,1771,"reading"
"2512",4,1,119,167,6383684,6385922,2238,"reading"
"2523",4,1,96,168,6388073,6389506,1433,"reading"
"2543",4,1,120,169,6394157,6397173,3016,"reading"
"2553",4,1,103,170,6398911,6402106,3195,"reading"
"2562",4,1,112,171,6403348,6405676,2328,"reading"
"2573",4,1,100,172,6406895,6412857,5962,"reading"
"2592",4,1,116,173,6417387,6420524,3137,"reading"
"2602",4,1,117,174,6422047,6424523,2476,"reading"
"2613",4,1,102,175,6425923,6429974,4051,"reading"
"2631",4,1,115,176,6435698,6437924,2226,"reading"
"2643",4,1,97,177,6439387,6441391,2004,"reading"
"2662",4,1,94,178,6446364,6451208,4844,"reading"
"2682",4,1,93,179,6455127,6456508,1381,"reading"
"2701",4,1,106,180,6460691,6463208,2517,"reading"
"1013",5,1,87,1,1080390,1086083,5693,"reading"
"1110",5,1,83,2,1089339,1094983,5644,"reading"
"1213",5,1,71,3,1098002,1105034,7032,"reading"
"142",5,1,72,4,1112348,1118017,5669,"reading"
"1616",5,1,75,5,1123799,1128701,4902,"reading"
"1713",5,1,76,6,1131562,1137818,6256,"reading"
"1812",5,1,74,7,1141573,1146652,5079,"reading"
"1910",5,1,73,8,1149512,1154069,4557,"reading"
"2012",5,1,62,9,1174248,1181153,6905,"reading"
"2214",5,1,79,10,1188552,1192153,3601,"reading"
"2316",5,1,85,11,1200357,1208437,8080,"reading"
"2414",5,1,86,12,1210536,1218388,7852,"reading"
"2513",5,1,68,13,1221260,1229354,8094,"reading"
"274",5,1,82,14,1237581,1246238,8657,"reading"
"283",5,1,81,15,1249934,1258505,8571,"reading"
"293",5,1,80,16,1263477,1272573,9096,"reading"
"304",5,1,78,17,1313823,1319177,5354,"reading"
"313",5,1,66,18,1322915,1327911,4996,"reading"
"331",5,1,77,19,1333795,1337194,3399,"reading"
"344",5,1,88,20,1339088,1345212,6124,"reading"
"352",5,1,89,21,1347590,1353678,6088,"reading"
"363",5,1,70,22,1357601,1364878,7277,"reading"
"381",5,1,69,23,1371937,1377896,5959,"reading"
"403",5,1,84,24,1386127,1391796,5669,"reading"
"414",5,1,64,25,1395023,1400730,5707,"reading"
"433",5,1,67,26,1408033,1414730,6697,"reading"
"451",5,1,90,27,1420047,1426147,6100,"reading"
"473",5,1,63,29,1470046,1475982,5936,"reading"
"493",5,1,65,30,1481371,1485482,4111,"reading"
"512",5,1,61,31,1492020,1497550,5530,"reading"
"531",5,2,1,32,1503659,1510083,6424,"reading"
"55",5,2,2,33,1516126,1522484,6358,"reading"
"572",5,2,3,34,1528506,1534084,5578,"reading"
"593",5,3,45,35,1539472,1544801,5329,"reading"
"604",5,3,53,36,1547610,1554201,6591,"reading"
"613",5,2,23,37,1556469,1562152,5683,"reading"
"622",5,3,46,38,1564751,1570135,5384,"reading"
"634",5,3,39,39,1572777,1578252,5475,"reading"
"654",5,3,42,40,1584619,1589686,5067,"reading"
"672",5,3,31,41,1596201,1602086,5885,"reading"
"691",5,2,18,42,1608707,1614737,6030,"reading"
"703",5,2,28,43,1782422,1788660,6238,"reading"
"712",5,3,37,44,1790404,1795310,4906,"reading"
"733",5,2,14,45,1801057,1805594,4537,"reading"
"744",5,3,32,46,1807601,1813627,6026,"reading"
"763",5,2,5,47,1818684,1823311,4627,"reading"
"782",5,3,44,48,1828819,1833828,5009,"reading"
"794",5,2,8,49,1836212,1841411,5199,"reading"
"813",5,2,7,50,1848100,1853845,5745,"reading"
"833",5,2,29,51,1859283,1863412,4129,"reading"
"843",5,2,12,52,1867312,1872346,5034,"reading"
"861",5,2,4,53,1878173,1883646,5473,"reading"
"882",5,3,47,54,1889942,1896846,6904,"reading"
"894",5,2,24,55,1899643,1904380,4737,"reading"
"903",5,3,51,56,1907951,1913614,5663,"reading"
"913",5,3,55,57,1915926,1919531,3605,"reading"
"924",5,3,60,58,1921984,1927631,5647,"reading"
"933",5,3,58,59,1929762,1935465,5703,"reading"
"943",5,2,20,60,1937842,1941415,3573,"reading"
"954",5,3,34,61,1943962,1948882,4920,"reading"
"974",5,2,25,62,1955309,1959599,4290,"reading"
"984",5,3,56,63,1961568,1966415,4847,"reading"
"992",5,2,6,64,1968191,1972600,4409,"reading"
"1014",5,2,26,65,1978664,1983350,4686,"reading"
"1024",5,2,21,66,1985717,1989067,3350,"reading"
"1032",5,2,15,67,1992089,1997517,5428,"reading"
"1042",5,3,33,68,1999836,2006817,6981,"reading"
"1064",5,3,59,69,2012706,2017501,4795,"reading"
"1073",5,2,9,70,2020230,2024235,4005,"reading"
"1093",5,3,52,71,2030205,2034701,4496,"reading"
"1103",5,2,11,72,2036713,2041868,5155,"reading"
"1123",5,2,30,73,2047647,2051752,4105,"reading"
"1134",5,3,48,74,2053902,2059585,5683,"reading"
"1141",5,3,38,75,2062152,2066919,4767,"reading"
"1162",5,2,17,76,2072041,2078320,6279,"reading"
"1172",5,3,49,77,2081047,2085870,4823,"reading"
"1183",5,3,57,78,2088138,2093420,5282,"reading"
"1193",5,3,35,79,2095222,2099437,4215,"reading"
"1214",5,2,13,80,2105305,2109453,4148,"reading"
"1224",5,2,27,81,2111255,2116071,4816,"reading"
"1232",5,2,19,82,2118195,2121904,3709,"reading"
"1242",5,2,10,83,2124253,2128454,4201,"reading"
"1264",5,3,54,84,2134631,2140405,5774,"reading"
"1273",5,3,43,85,2142368,2147921,5553,"reading"
"1283",5,3,40,86,2151883,2156289,4406,"reading"
"1303",5,2,16,87,2161954,2169223,7269,"reading"
"1311",5,2,22,88,2171549,2176073,4524,"reading"
"1323",5,3,36,89,2178013,2182489,4476,"reading"
"1342",5,3,50,90,2188044,2192123,4079,"reading"
"1353",5,3,41,91,2194409,2199307,4898,"reading"
"146",5,1,171,92,2451312,2458966,7654,"zString"
"1474",5,1,161,93,2460806,2468233,7427,"zString"
"1494",5,1,177,94,2473338,2479900,6562,"zString"
"150",5,1,154,95,2482025,2490150,8125,"zString"
"1522",5,1,155,96,2495305,2503867,8562,"zString"
"1542",5,1,165,97,2509093,2516451,7358,"zString"
"1554",5,1,174,98,2518831,2527001,8170,"zString"
"1562",5,1,178,99,2529053,2536269,7216,"zString"
"1574",5,1,172,100,2538497,2548869,10372,"zString"
"1582",5,1,170,101,2551020,2561686,10666,"zString"
"1592",5,1,153,102,2563590,2570687,7097,"zString"
"1617",5,1,160,103,2577837,2586654,8817,"zString"
"1632",5,1,179,104,2592466,2601237,8771,"zString"
"1643",5,1,152,105,2606432,2614355,7923,"zString"
"1664",5,1,157,106,2620483,2627472,6989,"zString"
"1683",5,1,176,107,2632692,2640822,8130,"zString"
"1693",5,1,164,108,2643016,2653523,10507,"zString"
"1702",5,1,175,109,2655463,2663606,8143,"zString"
"1714",5,1,158,110,2666478,2672873,6395,"zString"
"1733",5,1,163,111,2679103,2685757,6654,"zString"
"1743",5,1,162,112,2688489,2694890,6401,"zString"
"1764",5,1,180,113,2700658,2708725,8067,"zString"
"1773",5,1,169,114,2712203,2717892,5689,"zString"
"1782",5,1,166,115,2719952,2725708,5756,"zString"
"1793",5,1,173,116,2728303,2733575,5272,"zString"
"1804",5,1,159,117,2735564,2742242,6678,"zString"
"1823",5,1,156,118,2747665,2755310,7645,"zString"
"1844",5,1,151,119,2760573,2768160,7587,"zString"
"1862",5,1,167,120,2772696,2779677,6981,"zString"
"1874",5,1,168,121,2782303,2789360,7057,"zString"
"1882",5,2,91,122,2791478,2798261,6783,"zString"
"1902",5,2,92,123,2803295,2810445,7150,"zString"
"1922",5,2,93,124,2816355,2821278,4923,"zString"
"1941",5,3,134,125,2827048,2833412,6364,"zString"
"1954",5,2,102,126,2835893,2841396,5503,"zString"
"1974",5,3,133,127,2846234,2852096,5862,"zString"
"1982",5,3,138,128,2854775,2860329,5554,"zString"
"1993",5,2,112,129,2862524,2869230,6706,"zString"
"2004",5,3,127,130,2871063,2878564,7501,"zString"
"2023",5,2,107,131,2883424,2889681,6257,"zString"
"2032",5,3,140,132,2892193,2898764,6571,"zString"
"2044",5,3,123,133,2939123,2945684,6561,"zString"
"2063",5,3,142,134,2951072,2957034,5962,"zString"
"2074",5,2,95,135,2959486,2964818,5332,"zString"
"2093",5,2,106,136,2970780,2976335,5555,"zString"
"2104",5,3,136,137,2980746,2986535,5789,"zString"
"2114",5,2,97,138,2989413,2993686,4273,"zString"
"2131",5,2,120,139,3000016,3007170,7154,"zString"
"2143",5,3,143,140,3009395,3016170,6775,"zString"
"2152",5,2,119,141,3025048,3032653,7605,"zString"
"2163",5,3,146,142,3042260,3047838,5578,"zString"
"2174",5,3,131,143,3051069,3056588,5519,"zString"
"2193",5,3,125,144,3061689,3067921,6232,"zString"
"2215",5,3,130,145,3116497,3121673,5176,"zString"
"2233",5,2,98,146,3126405,3131124,4719,"zString"
"2262",5,2,116,148,3174868,3178859,3991,"zString"
"2273",5,2,100,149,3181063,3185992,4929,"zString"
"2293",5,2,114,150,3190612,3194309,3697,"zString"
"2302",5,2,113,151,3196186,3200059,3873,"zString"
"2317",5,3,139,152,3202858,3207127,4269,"zString"
"2323",5,3,128,153,3208979,3213576,4597,"zString"
"2343",5,2,103,154,3218132,3223694,5562,"zString"
"2352",5,2,115,155,3225638,3230877,5239,"zString"
"2364",5,3,150,156,3233013,3238346,5333,"zString"
"2372",5,3,124,157,3240827,3247328,6501,"zString"
"2392",5,2,105,158,3252494,3258045,5551,"zString"
"2402",5,3,149,159,3260588,3263662,3074,"zString"
"2415",5,2,96,160,3266901,3271646,4745,"zString"
"2433",5,3,145,161,3276569,3281446,4877,"zString"
"2444",5,2,111,162,3284113,3289097,4984,"zString"
"2453",5,2,117,163,3291834,3295329,3495,"zString"
"2463",5,2,110,164,3297472,3302929,5457,"zString"
"2472",5,3,126,165,3304750,3308847,4097,"zString"
"2492",5,3,137,166,3313612,3320516,6904,"zString"
"2503",5,3,121,167,3322580,3327765,5185,"zString"
"2524",5,2,101,168,3332729,3336716,3987,"zString"
"2544",5,3,122,169,3340784,3346215,5431,"zString"
"2563",5,3,132,170,3350648,3356981,6333,"zString"
"2582",5,3,141,171,3361605,3367718,6113,"zString"
"2593",5,2,108,172,3371222,3377467,6245,"zString"
"2603",5,2,99,173,3379684,3385249,5565,"zString"
"2623",5,3,144,174,3390585,3396649,6064,"zString"
"2632",5,2,94,175,3398889,3403233,4344,"zString"
"2652",5,3,129,176,3409240,3416100,6860,"zString"
"2673",5,3,148,177,3420913,3427467,6554,"zString"
"2683",5,3,147,178,3429593,3435584,5991,"zString"
"2693",5,3,135,179,3438514,3444384,5870,"zString"
"2702",5,2,104,180,3446577,3451901,5324,"zString"
"2711",5,2,109,181,3454088,3457585,3497,"zString"
"2721",5,2,118,182,3461176,3466002,4826,"zString"
"1015",6,1,51,1,4180102,4183576,3474,"zString"
"1113",6,1,32,2,4187081,4190610,3529,"zString"
"137",6,1,48,3,4196673,4200894,4221,"zString"
"143",6,1,59,4,4206616,4210310,3694,"zString"
"1510",6,1,49,5,4213512,4215861,2349,"zString"
"1618",6,1,31,6,4219197,4223894,4697,"zString"
"1813",6,1,38,7,4229426,4233261,3835,"zString"
"2013",6,1,41,8,4239078,4241478,2400,"zString"
"2216",6,1,45,9,4246764,4249162,2398,"zString"
"2318",6,1,33,10,4252793,4255129,2336,"zString"
"2514",6,1,56,11,4262203,4266096,3893,"zString"
"2614",6,1,39,12,4270761,4274346,3585,"zString"
"284",6,1,58,13,4279418,4282380,2962,"zString"
"294",6,1,54,14,4286227,4288963,2736,"zString"
"305",6,1,43,15,4291513,4295064,3551,"zString"
"314",6,1,40,16,4298839,4302447,3608,"zString"
"332",6,1,35,17,4307882,4310898,3016,"zString"
"353",6,1,34,18,4315844,4319298,3454,"zString"
"374",6,1,46,19,4323504,4325948,2444,"zString"
"382",6,1,57,20,4328215,4330998,2783,"zString"
"394",6,1,53,21,4333640,4336048,2408,"zString"
"404",6,1,42,22,4338969,4341965,2996,"zString"
"423",6,1,52,23,4347197,4351215,4018,"zString"
"434",6,1,55,24,4353228,4356799,3571,"zString"
"444",6,1,44,25,4360660,4363916,3256,"zString"
"452",6,1,47,26,4366670,4370133,3463,"zString"
"463",6,1,37,27,4372795,4374800,2005,"zString"
"483",6,1,60,28,4379475,4382483,3008,"zString"
"494",6,1,36,29,4385315,4388550,3235,"zString"
"513",6,1,50,30,4392763,4396334,3571,"zString"
"523",6,2,61,31,4402884,4405768,2884,"zString"
"544",6,2,62,32,4410190,4413251,3061,"zString"
"564",6,2,63,33,4417369,4420384,3015,"zString"
"583",6,3,21,34,4424434,4427084,2650,"zString"
"594",6,3,6,35,4429680,4432685,3005,"zString"
"614",6,2,70,36,4436977,4439452,2475,"zString"
"635",6,3,8,37,4443697,4446519,2822,"zString"
"655",6,2,89,38,4450820,4453169,2349,"zString"
"663",6,2,75,39,4455723,4458752,3029,"zString"
"673",6,2,83,40,4461433,4464952,3519,"zString"
"684",6,3,15,41,4466963,4469920,2957,"zString"
"692",6,2,81,42,4517015,4519056,2041,"zString"
"704",6,3,22,43,4521664,4523540,1876,"zString"
"713",6,2,82,44,4525665,4527973,2308,"zString"
"723",6,2,67,45,4530146,4532590,2444,"zString"
"745",6,2,88,46,4536401,4539256,2855,"zString"
"752",6,2,76,47,4542010,4544690,2680,"zString"
"764",6,2,64,48,4546744,4550090,3346,"zString"
"783",6,2,79,49,4554173,4556990,2817,"zString"
"795",6,3,29,50,4558965,4561857,2892,"zString"
"802",6,3,14,51,4563884,4565457,1573,"zString"
"814",6,2,72,52,4568009,4570808,2799,"zString"
"834",6,3,24,53,4574986,4577675,2689,"zString"
"844",6,3,7,54,4580255,4582508,2253,"zString"
"862",6,2,86,55,4586731,4589258,2527,"zString"
"874",6,2,77,56,4591583,4593442,1859,"zString"
"883",6,3,3,57,4595968,4598842,2874,"zString"
"904",6,2,73,58,4603324,4605642,2318,"zString"
"914",6,3,30,59,4607940,4610926,2986,"zString"
"925",6,3,18,60,4613283,4615193,1910,"zString"
"934",6,3,12,61,4618149,4620493,2344,"zString"
"955",6,2,65,62,4624807,4626959,2152,"zString"
"975",6,3,1,63,4631620,4633526,1906,"zString"
"993",6,3,27,64,4637381,4639410,2029,"zString"
"1004",6,3,25,65,4642011,4643777,1766,"zString"
"1016",6,2,87,66,4645855,4648444,2589,"zString"
"1025",6,2,85,67,4650656,4653294,2638,"zString"
"1033",6,2,71,68,4655583,4658827,3244,"zString"
"1052",6,3,5,69,4663000,4665194,2194,"zString"
"1074",6,2,78,70,4669533,4672044,2511,"zString"
"1083",6,3,2,71,4674312,4677011,2699,"zString"
"1104",6,2,66,72,4680949,4683311,2362,"zString"
"1124",6,3,28,73,4687908,4691528,3620,"zString"
"1135",6,2,90,74,4693946,4696628,2682,"zString"
"1142",6,3,4,75,4700160,4702779,2619,"zString"
"1163",6,3,26,76,4707266,4709512,2246,"zString"
"1173",6,2,84,77,4711756,4714879,3123,"zString"
"1184",6,3,11,78,4718001,4721413,3412,"zString"
"1204",6,3,23,79,4725618,4728263,2645,"zString"
"1215",6,3,16,80,4730947,4734230,3283,"zString"
"1225",6,3,9,81,4737549,4739697,2148,"zString"
"1243",6,2,74,82,4743920,4746031,2111,"zString"
"1253",6,2,69,83,4748850,4750831,1981,"zString"
"1274",6,2,68,84,4755271,4757947,2676,"zString"
"1293",6,3,19,85,4762127,4764864,2737,"zString"
"1304",6,3,17,86,4767553,4769764,2211,"zString"
"1312",6,3,10,87,4772083,4773715,1632,"zString"
"1333",6,2,80,88,4778079,4780831,2752,"zString"
"1343",6,3,13,89,4782931,4784799,1868,"zString"
"1354",6,3,20,90,4787670,4789682,2012,"zString"
"1454",6,1,147,91,4867892,4871251,3359,"reading"
"1461",6,1,138,92,4873518,4877602,4084,"reading"
"1475",6,1,130,93,4879842,4883685,3843,"reading"
"1495",6,1,122,94,4888982,4891269,2287,"reading"
"1514",6,1,133,95,4896949,4900052,3103,"reading"
"1523",6,1,128,96,4902241,4905219,2978,"reading"
"1543",6,1,127,97,4911106,4913236,2130,"reading"
"1563",6,1,126,98,4920253,4923337,3084,"reading"
"1583",6,1,124,99,4929911,4933120,3209,"reading"
"1603",6,1,121,100,4940184,4943371,3187,"reading"
"1623",6,1,143,101,4947842,4952054,4212,"reading"
"1633",6,1,150,102,4954186,4957805,3619,"reading"
"1644",6,1,144,103,4959728,4963021,3293,"reading"
"1652",6,1,142,104,4965112,4968938,3826,"reading"
"1665",6,1,140,105,4971292,4974405,3113,"reading"
"1672",6,1,148,106,4976959,4980888,3929,"reading"
"1684",6,1,132,107,4983154,4987957,4803,"reading"
"1703",6,1,139,108,4993670,4995839,2169,"reading"
"1715",6,1,141,109,4999601,5002739,3138,"reading"
"1724",6,1,149,110,5005413,5009306,3893,"reading"
"1734",6,1,137,111,5011474,5016590,5116,"reading"
"1744",6,1,125,112,5018623,5021574,2951,"reading"
"1765",6,1,136,113,5025666,5028240,2574,"reading"
"1774",6,1,123,114,5030099,5033124,3025,"reading"
"1794",6,1,135,115,5037416,5040274,2858,"reading"
"1805",6,1,134,116,5042895,5046476,3581,"reading"
"1814",6,1,129,117,5049429,5052726,3297,"reading"
"1833",6,1,145,118,5057862,5060242,2380,"reading"
"1845",6,1,146,119,5062073,5066158,4085,"reading"
"1853",6,1,131,120,5068522,5071008,2486,"reading"
"1875",6,2,151,121,5075878,5079908,4030,"reading"
"1893",6,2,152,122,5085305,5090842,5537,"reading"
"1914",6,2,153,123,5097866,5100676,2810,"reading"
"1934",6,2,165,124,5105266,5109043,3777,"reading"
"1942",6,2,173,125,5111806,5114426,2620,"reading"
"1955",6,3,101,126,5116520,5118860,2340,"reading"
"1975",6,2,158,127,5123489,5126777,3288,"reading"
"1994",6,3,98,128,5131381,5133644,2263,"reading"
"2014",6,2,177,129,5138378,5141527,3149,"reading"
"2024",6,3,108,130,5143538,5145761,2223,"reading"
"2033",6,2,178,131,5148161,5151027,2866,"reading"
"2045",6,3,118,132,5191971,5195312,3341,"reading"
"2053",6,3,103,133,5197441,5200496,3055,"reading"
"2064",6,2,157,134,5203130,5206479,3349,"reading"
"2083",6,3,104,135,5211298,5213396,2098,"reading"
"2094",6,2,163,136,5215646,5218363,2717,"reading"
"2105",6,2,166,137,5220479,5223197,2718,"reading"
"2115",6,3,105,138,5225194,5227063,1869,"reading"
"2123",6,3,114,139,5229427,5232564,3137,"reading"
"2132",6,2,176,140,5235480,5238347,2867,"reading"
"2144",6,3,95,141,5240543,5243198,2655,"reading"
"2164",6,2,159,142,5247932,5252498,4566,"reading"
"2184",6,3,115,143,5256571,5258865,2294,"reading"
"2194",6,2,169,144,5261030,5264415,3385,"reading"
"2203",6,2,155,145,5266858,5270965,4107,"reading"
"2222",6,2,170,146,5275221,5277982,2761,"reading"
"2234",6,3,102,147,5280078,5282416,2338,"reading"
"2254",6,2,164,148,5288088,5290849,2761,"reading"
"2263",6,3,100,149,5292753,5295449,2696,"reading"
"2283",6,3,120,150,5300524,5303900,3376,"reading"
"2294",6,2,172,151,5306567,5308516,1949,"reading"
"2303",6,2,154,152,5311378,5314100,2722,"reading"
"2324",6,2,161,153,5318547,5321933,3386,"reading"
"2344",6,2,167,154,5327455,5330234,2779,"reading"
"2353",6,2,168,155,5332648,5335434,2786,"reading"
"2365",6,3,99,156,5337470,5339551,2081,"reading"
"2382",6,3,107,157,5344236,5346218,1982,"reading"
"2393",6,2,160,158,5348514,5351585,3071,"reading"
"2416",6,2,171,159,5356791,5358918,2127,"reading"
"2422",6,3,106,160,5361895,5365719,3824,"reading"
"2434",6,3,109,161,5367879,5370018,2139,"reading"
"2445",6,3,112,162,5372628,5374535,1907,"reading"
"2454",6,2,180,163,5376546,5380652,4106,"reading"
"2464",6,3,117,164,5382700,5384419,1719,"reading"
"2473",6,3,96,165,5386304,5388002,1698,"reading"
"2493",6,2,156,166,5393348,5395819,2471,"reading"
"2515",6,3,93,167,5400738,5402903,2165,"reading"
"2532",6,3,116,168,5407180,5409603,2423,"reading"
"2545",6,2,162,169,5411409,5413537,2128,"reading"
"2564",6,2,174,170,5418339,5421004,2665,"reading"
"2574",6,3,91,171,5422933,5425154,2221,"reading"
"2594",6,3,97,172,5432056,5433921,1865,"reading"
"2615",6,3,111,173,5438006,5440571,2565,"reading"
"2624",6,3,94,174,5442968,5445454,2486,"reading"
"2644",6,2,175,175,5450651,5452572,1921,"reading"
"2653",6,3,92,176,5454843,5457972,3129,"reading"
"2674",6,2,179,177,5462591,5464855,2264,"reading"
"2684",6,3,119,178,5467127,5469607,2480,"reading"
"2694",6,3,113,179,5471717,5473922,2205,"reading"
"2703",6,3,110,180,5476109,5478089,1980,"reading"
"1017",7,2,31,1,820405,826677,6272,"reading"
"1216",7,2,32,2,835193,839828,4635,"reading"
"144",7,2,33,3,846234,853778,7544,"reading"
"1619",7,3,84,4,862524,869745,7221,"reading"
"1716",7,2,58,5,873147,877712,4565,"reading"
"1815",7,2,57,6,880079,886129,6050,"reading"
"1915",7,3,88,7,888781,894230,5449,"reading"
"2015",7,3,63,8,897277,902280,5003,"reading"
"2217",7,2,52,9,909386,913847,4461,"reading"
"2319",7,3,82,10,917381,922314,4933,"reading"
"2417",7,3,78,11,924438,930532,6094,"reading"
"2516",7,3,83,12,935072,939849,4777,"reading"
"2616",7,3,87,13,963929,969316,5387,"reading"
"275",7,3,64,14,972091,975649,3558,"reading"
"295",7,3,76,15,982757,985750,2993,"reading"
"306",7,2,42,16,988524,993650,5126,"reading"
"324",7,3,86,17,999337,1007400,8063,"reading"
"333",7,2,36,18,1010156,1014267,4111,"reading"
"354",7,3,69,19,1018876,1023018,4142,"reading"
"375",7,2,48,20,1028822,1034801,5979,"reading"
"383",7,2,56,21,1036983,1041452,4469,"reading"
"395",7,2,34,22,1044521,1049003,4482,"reading"
"415",7,3,65,23,1054361,1058636,4275,"reading"
"435",7,2,59,24,1065960,1070119,4159,"reading"
"445",7,3,75,25,1073750,1078320,4570,"reading"
"453",7,3,77,26,1081091,1084236,3145,"reading"
"464",7,2,40,27,1087131,1090404,3273,"reading"
"484",7,3,73,28,1096236,1099469,3233,"reading"
"495",7,3,79,29,1101976,1106554,4578,"reading"
"503",7,3,66,30,1108955,1112021,3066,"reading"
"524",7,2,60,31,1118147,1121589,3442,"reading"
"532",7,3,67,32,1123898,1127788,3890,"reading"
"551",7,3,80,33,1136806,1142321,5515,"reading"
"565",7,2,38,34,1144788,1152257,7469,"reading"
"584",7,2,51,35,1159596,1166209,6613,"reading"
"595",7,3,72,36,1171811,1176873,5062,"reading"
"615",7,2,49,37,1183294,1188940,5646,"reading"
"623",7,2,54,38,1191550,1196440,4890,"reading"
"636",7,2,39,39,1199686,1203474,3788,"reading"
"656",7,2,37,40,1209901,1214923,5022,"reading"
"674",7,2,50,41,1220429,1225860,5431,"reading"
"685",7,3,85,42,1289874,1294612,4738,"reading"
"693",7,2,46,43,1297663,1303095,5432,"reading"
"705",7,3,89,44,1305467,1309379,3912,"reading"
"714",7,3,71,45,1311940,1317497,5557,"reading"
"734",7,3,70,46,1323679,1329515,5836,"reading"
"753",7,3,81,47,1338127,1343232,5105,"reading"
"765",7,3,90,48,1345508,1350115,4607,"reading"
"773",7,2,41,49,1355978,1360015,4037,"reading"
"796",7,2,45,50,1366074,1374148,8074,"reading"
"803",7,2,53,51,1376519,1380881,4362,"reading"
"815",7,2,47,52,1383384,1389115,5731,"reading"
"822",7,2,43,53,1391216,1395749,4533,"reading"
"835",7,3,68,54,1398034,1403533,5499,"reading"
"853",7,3,61,55,1409197,1415750,6553,"reading"
"875",7,2,44,56,1424800,1428584,3784,"reading"
"884",7,2,35,57,1432709,1435483,2774,"reading"
"905",7,3,74,58,1440710,1445734,5024,"reading"
"915",7,2,55,59,1448464,1452585,4121,"reading"
"926",7,3,62,60,1454861,1459818,4957,"reading"
"944",7,1,17,61,1465669,1472052,6383,"reading"
"956",7,1,13,62,1474388,1479102,4714,"reading"
"963",7,1,10,63,1481382,1485168,3786,"reading"
"985",7,1,14,64,1490580,1494385,3805,"reading"
"994",7,1,27,65,1496741,1501520,4779,"reading"
"1005",7,1,8,66,1504155,1510571,6416,"reading"
"1026",7,1,28,67,1516368,1519386,3018,"reading"
"1034",7,1,25,68,1521759,1525470,3711,"reading"
"1043",7,1,19,69,1527301,1533437,6136,"reading"
"1053",7,1,3,70,1535516,1542654,7138,"reading"
"1075",7,1,6,71,1549839,1554521,4682,"reading"
"1094",7,1,9,72,1562895,1566905,4010,"reading"
"1114",7,1,22,73,1574583,1579006,4423,"reading"
"1125",7,1,26,74,1581026,1584206,3180,"reading"
"1136",7,1,5,75,1586190,1590008,3818,"reading"
"1154",7,1,29,76,1597548,1602255,4707,"reading"
"1164",7,1,4,77,1604727,1609657,4930,"reading"
"1185",7,1,12,78,1615382,1621009,5627,"reading"
"1205",7,1,7,79,1626727,1632925,6198,"reading"
"1226",7,1,11,80,1639757,1650391,10634,"reading"
"1244",7,1,30,81,1656367,1661908,5541,"reading"
"1254",7,1,24,82,1664370,1670009,5639,"reading"
"1265",7,1,15,83,1672121,1676176,4055,"reading"
"1275",7,1,16,84,1678082,1682626,4544,"reading"
"1284",7,1,1,85,1686517,1691527,5010,"reading"
"1305",7,1,18,86,1696966,1700977,4011,"reading"
"1313",7,1,20,87,1703761,1707727,3966,"reading"
"1324",7,1,21,88,1709900,1714144,4244,"reading"
"1334",7,1,2,89,1716442,1722694,6252,"reading"
"1355",7,1,23,90,1728284,1733444,5160,"reading"
"1455",7,2,121,91,1843294,1846164,2870,"zString"
"1476",7,2,122,92,1850368,1853282,2914,"zString"
"1496",7,2,123,93,1857516,1860466,2950,"zString"
"1515",7,2,124,94,1866218,1870732,4514,"zString"
"1532",7,3,157,95,1875500,1878832,3332,"zString"
"1555",7,2,138,96,1883201,1885532,2331,"zString"
"1564",7,3,167,97,1888233,1891433,3200,"zString"
"1575",7,2,129,98,1893537,1895883,2346,"zString"
"1593",7,3,174,99,1900503,1902933,2430,"zString"
"1604",7,3,169,100,1905965,1907983,2018,"zString"
"16110",7,2,125,101,1910513,1913167,2654,"zString"
"1634",7,2,127,102,1918783,1921084,2301,"zString"
"1653",7,3,168,103,1925025,1927633,2608,"zString"
"1666",7,2,147,104,1929936,1932718,2782,"zString"
"1673",7,3,164,105,1935134,1937817,2683,"zString"
"1685",7,2,130,106,1939879,1942218,2339,"zString"
"1704",7,3,153,107,1947038,1949418,2380,"zString"
"1725",7,3,180,108,1955065,1958185,3120,"zString"
"1735",7,3,178,109,1960172,1962685,2513,"zString"
"1745",7,2,144,110,1965204,1968503,3299,"zString"
"1754",7,2,135,111,1970645,1973369,2724,"zString"
"1766",7,3,151,112,1975862,1978652,2790,"zString"
"1783",7,3,163,113,1983684,1986186,2502,"zString"
"1795",7,3,158,114,1988333,1990936,2603,"zString"
"1816",7,3,159,115,1995946,1998420,2474,"zString"
"1834",7,3,162,116,2003350,2006053,2703,"zString"
"1854",7,2,133,117,2010359,2012688,2329,"zString"
"1863",7,3,177,118,2015115,2017772,2657,"zString"
"1876",7,3,160,119,2020042,2023487,3445,"zString"
"1894",7,2,148,120,2027974,2032187,4213,"zString"
"1903",7,3,155,121,2034518,2036987,2469,"zString"
"1923",7,2,131,122,2042497,2045388,2891,"zString"
"1943",7,2,128,123,2050092,2052872,2780,"zString"
"1962",7,3,165,124,2058008,2060939,2931,"zString"
"1976",7,3,176,125,2063134,2066791,3657,"zString"
"1983",7,2,126,126,2068876,2071122,2246,"zString"
"2005",7,2,139,127,2076491,2079039,2548,"zString"
"2016",7,2,134,128,2081014,2083223,2209,"zString"
"2025",7,3,161,129,2085853,2088239,2386,"zString"
"2046",7,3,175,130,2092758,2095989,3231,"zString"
"2054",7,3,172,131,2098157,2101457,3300,"zString"
"2065",7,2,140,132,2145199,2148375,3176,"zString"
"2075",7,3,152,133,2150882,2153875,2993,"zString"
"2095",7,3,173,134,2159764,2162276,2512,"zString"
"2106",7,3,156,135,2165029,2167858,2829,"zString"
"2124",7,2,150,136,2173644,2176092,2448,"zString"
"2133",7,3,179,137,2178402,2181895,3493,"zString"
"2145",7,2,142,138,2184999,2187226,2227,"zString"
"2153",7,3,171,139,2190870,2194161,3291,"zString"
"2165",7,2,137,140,2197593,2201143,3550,"zString"
"2175",7,2,132,141,2203959,2206594,2635,"zString"
"2195",7,2,141,142,2211660,2213710,2050,"zString"
"2204",7,2,145,143,2216063,2218294,2231,"zString"
"2218",7,2,143,144,2223165,2225577,2412,"zString"
"2223",7,2,146,145,2228554,2230994,2440,"zString"
"2235",7,3,170,146,2234329,2236461,2132,"zString"
"2244",7,2,149,147,2238963,2241261,2298,"zString"
"2255",7,2,136,148,2243441,2246146,2705,"zString"
"2264",7,3,166,149,2248210,2250695,2485,"zString"
"2274",7,3,154,150,2252915,2255063,2148,"zString"
"2295",7,1,92,151,2260393,2263245,2852,"zString"
"23110",7,1,105,152,2268382,2270545,2163,"zString"
"2325",7,1,109,153,2273235,2274662,1427,"zString"
"2334",7,1,111,154,2277401,2279495,2094,"zString"
"2345",7,1,110,155,2281591,2283845,2254,"zString"
"2354",7,1,96,156,2286755,2289547,2792,"zString"
"2373",7,1,117,157,2293367,2295196,1829,"zString"
"2383",7,1,99,158,2297469,2299498,2029,"zString"
"2403",7,1,120,159,2303586,2306347,2761,"zString"
"2418",7,1,102,160,2308151,2310296,2145,"zString"
"2435",7,1,115,161,2314967,2317648,2681,"zString"
"2446",7,1,93,162,2321015,2325016,4001,"zString"
"2465",7,1,108,163,2329362,2332148,2786,"zString"
"2474",7,1,116,164,2334116,2337132,3016,"zString"
"2483",7,1,95,165,2339448,2342266,2818,"zString"
"2504",7,1,106,166,2346838,2349964,3126,"zString"
"2517",7,1,94,167,2352605,2354531,1926,"zString"
"2533",7,1,100,168,2360032,2363099,3067,"zString"
"2554",7,1,101,169,2367644,2370065,2421,"zString"
"2575",7,1,103,170,2374562,2377718,3156,"zString"
"2583",7,1,113,171,2380805,2382966,2161,"zString"
"2595",7,1,118,172,2385124,2387483,2359,"zString"
"2604",7,1,97,173,2389449,2391616,2167,"zString"
"2625",7,1,119,174,2395658,2398766,3108,"zString"
"2633",7,1,107,175,2400712,2404533,3821,"zString"
"2645",7,1,112,176,2406543,2410000,3457,"zString"
"2654",7,1,104,177,2412219,2414851,2632,"zString"
"2663",7,1,98,178,2419505,2422201,2696,"zString"
"2685",7,1,114,179,2426597,2428950,2353,"zString"
"2695",7,1,91,180,2431307,2433969,2662,"zString"
"1018",8,2,1,1,4064460,4068806,4346,"zString"
"1217",8,2,2,2,4074169,4077006,2837,"zString"
"1410",8,2,3,3,4082269,4085440,3171,"zString"
"1620",8,2,5,4,4090112,4093123,3011,"zString"
"1817",8,3,52,5,4099013,4103990,4977,"zString"
"1916",8,3,41,6,4106735,4110923,4188,"zString"
"2116",8,3,44,7,4116416,4120858,4442,"zString"
"2219",8,3,33,8,4122959,4126958,3999,"zString"
"2419",8,2,29,9,4131645,4135691,4046,"zString"
"2518",8,2,20,10,4137751,4142408,4657,"zString"
"2617",8,2,28,11,4144440,4149175,4735,"zString"
"276",8,3,47,12,4151492,4157575,6083,"zString"
"285",8,3,32,13,4160145,4166409,6264,"zString"
"307",8,2,17,14,4170813,4175243,4430,"zString"
"315",8,2,24,15,4177224,4182010,4786,"zString"
"325",8,3,43,16,4184032,4189360,5328,"zString"
"334",8,3,39,17,4191498,4196777,5279,"zString"
"355",8,3,37,18,4201099,4205094,3995,"zString"
"376",8,3,51,19,4210934,4216144,5210,"zString"
"384",8,2,26,20,4218452,4222878,4426,"zString"
"396",8,2,13,21,4224975,4228528,3553,"zString"
"405",8,2,9,22,4231461,4235162,3701,"zString"
"424",8,2,21,23,4239278,4243362,4084,"zString"
"436",8,2,4,24,4245884,4251495,5611,"zString"
"454",8,2,19,25,4255823,4260645,4822,"zString"
"465",8,2,27,26,4262169,4266362,4193,"zString"
"474",8,3,59,27,4268802,4275130,6328,"zString"
"485",8,2,22,28,4277174,4282030,4856,"zString"
"496",8,3,49,29,4284084,4288330,4246,"zString"
"504",8,2,6,30,4290426,4295246,4820,"zString"
"525",8,3,56,31,4299329,4304064,4735,"zString"
"533",8,2,8,32,4305948,4311997,6049,"zString"
"552",8,3,40,33,4316869,4322814,5945,"zString"
"573",8,3,34,34,4328174,4333398,5224,"zString"
"596",8,2,25,35,4337438,4341515,4077,"zString"
"605",8,3,54,36,4343302,4347515,4213,"zString"
"616",8,3,42,37,4349728,4354782,5054,"zString"
"637",8,2,18,38,4358568,4363066,4498,"zString"
"642",8,3,35,39,4365368,4370416,5048,"zString"
"664",8,2,23,40,4374902,4379716,4814,"zString"
"675",8,3,31,41,4381654,4386833,5179,"zString"
"694",8,3,57,42,4463562,4469052,5490,"zString"
"706",8,3,48,43,4471548,4476519,4971,"zString"
"715",8,2,15,44,4478531,4482470,3939,"zString"
"724",8,2,12,45,4485137,4490054,4917,"zString"
"746",8,3,50,46,4494884,4499320,4436,"zString"
"754",8,3,46,47,4501123,4504421,3298,"zString"
"766",8,3,60,48,4506526,4510871,4345,"zString"
"774",8,3,45,49,4512978,4516221,3243,"zString"
"784",8,2,11,50,4518870,4522988,4118,"zString"
"804",8,2,16,51,4527926,4532205,4279,"zString"
"816",8,2,10,52,4534475,4538388,3913,"zString"
"836",8,3,38,53,4543019,4548639,5620,"zString"
"854",8,2,30,54,4552688,4557589,4901,"zString"
"863",8,2,7,55,4559915,4563789,3874,"zString"
"885",8,3,53,56,4567920,4573240,5320,"zString"
"895",8,2,14,57,4575283,4578506,3223,"zString"
"906",8,3,55,58,4580330,4584424,4094,"zString"
"916",8,3,36,59,4586522,4590140,3618,"zString"
"935",8,3,58,60,4594371,4598357,3986,"zString"
"945",8,1,84,61,4600442,4604574,4132,"zString"
"957",8,1,88,62,4606691,4611141,4450,"zString"
"964",8,1,65,63,4613034,4616708,3674,"zString"
"986",8,1,71,64,4621099,4625375,4276,"zString"
"1006",8,1,85,65,4629356,4633608,4252,"zString"
"1019",8,1,82,66,4635530,4639892,4362,"zString"
"1027",8,1,69,67,4642130,4647242,5112,"zString"
"1044",8,1,67,68,4652065,4656026,3961,"zString"
"1065",8,1,86,69,4660207,4664409,4202,"zString"
"1076",8,1,76,70,4666327,4671260,4933,"zString"
"1084",8,1,64,71,4673409,4676977,3568,"zString"
"1105",8,1,87,72,4681135,4686027,4892,"zString"
"1115",8,1,68,73,4688205,4693811,5606,"zString"
"1137",8,1,83,74,4697542,4701711,4169,"zString"
"1143",8,1,62,75,4703602,4708677,5075,"zString"
"1165",8,1,78,76,4713260,4718528,5268,"zString"
"1174",8,1,63,77,4720468,4726411,5943,"zString"
"1194",8,1,73,78,4730378,4733978,3600,"zString"
"1206",8,1,77,79,4736222,4739078,2856,"zString"
"1218",8,1,72,80,4741117,4745146,4029,"zString"
"1233",8,1,74,81,4749246,4752496,3250,"zString"
"1245",8,1,61,82,4754401,4757963,3562,"zString"
"1266",8,1,70,83,4761906,4765580,3674,"zString"
"1285",8,1,81,84,4769228,4772963,3735,"zString"
"1294",8,1,75,85,4774849,4779413,4564,"zString"
"1306",8,1,66,86,4781096,4785463,4367,"zString"
"1325",8,1,79,87,4789448,4793414,3966,"zString"
"1335",8,1,89,88,4796183,4800847,4664,"zString"
"1344",8,1,80,89,4802461,4807081,4620,"zString"
"1356",8,1,90,90,4808921,4813131,4210,"zString"
"1456",8,2,91,91,4992974,4997554,4580,"reading"
"1477",8,2,92,92,5003028,5007154,4126,"reading"
"1497",8,2,93,93,5012507,5016672,4165,"reading"
"1516",8,2,112,94,5021953,5026055,4102,"reading"
"1524",8,2,108,95,5027757,5032589,4832,"reading"
"1533",8,2,99,96,5034631,5037955,3324,"reading"
"1556",8,2,118,97,5043461,5047456,3995,"reading"
"1565",8,2,100,98,5049319,5054490,5171,"reading"
"1584",8,2,116,99,5059239,5062873,3634,"reading"
"1594",8,3,134,100,5064837,5071790,6953,"reading"
"1605",8,3,146,101,5073393,5078024,4631,"reading"
"16111",8,2,98,102,5080111,5083591,3480,"reading"
"1635",8,2,104,103,5087938,5091807,3869,"reading"
"1645",8,2,114,104,5093481,5100291,6810,"reading"
"1654",8,3,121,105,5102277,5106108,3831,"reading"
"1674",8,3,139,106,5112561,5116525,3964,"reading"
"1686",8,3,123,107,5118492,5123192,4700,"reading"
"1705",8,2,106,108,5128912,5133875,4963,"reading"
"1717",8,3,140,109,5135801,5140176,4375,"reading"
"1726",8,3,125,110,5141801,5148109,6308,"reading"
"1746",8,3,142,111,5152659,5156376,3717,"reading"
"1755",8,2,94,112,5158178,5162060,3882,"reading"
"1775",8,2,97,113,5166370,5169377,3007,"reading"
"1796",8,3,128,114,5173725,5178094,4369,"reading"
"1818",8,3,126,115,5188002,5193494,5492,"reading"
"1835",8,3,122,116,5198248,5203228,4980,"reading"
"1855",8,3,143,117,5207722,5212595,4873,"reading"
"1864",8,2,111,118,5214221,5218578,4357,"reading"
"1877",8,3,141,119,5220794,5226779,5985,"reading"
"1883",8,3,138,120,5228393,5233379,4986,"reading"
"1895",8,3,130,121,5235146,5242179,7033,"reading"
"1917",8,3,148,122,5245997,5250546,4549,"reading"
"1924",8,2,119,123,5252367,5257513,5146,"reading"
"1935",8,3,144,124,5259050,5267680,8630,"reading"
"1944",8,3,129,125,5269856,5274847,4991,"reading"
"1963",8,2,103,126,5279963,5283731,3768,"reading"
"1977",8,3,133,127,5285383,5288981,3598,"reading"
"1984",8,2,117,128,5291015,5294697,3682,"reading"
"1995",8,3,145,129,5296442,5301314,4872,"reading"
"2006",8,3,135,130,5304020,5309248,5228,"reading"
"2017",8,3,136,131,5311165,5315982,4817,"reading"
"2026",8,3,147,132,5497046,5502705,5659,"reading"
"2034",8,3,150,133,5504963,5508805,3842,"reading"
"2047",8,3,137,134,5510453,5514988,4535,"reading"
"2055",8,3,132,135,5516861,5521106,4245,"reading"
"2076",8,3,127,136,5526136,5532272,6136,"reading"
"2096",8,3,131,137,5536961,5541723,4762,"reading"
"2117",8,2,113,138,5546254,5550940,4686,"reading"
"2125",8,3,124,139,5552966,5556723,3757,"reading"
"2146",8,2,109,140,5561488,5566374,4886,"reading"
"2154",8,2,95,141,5568860,5573124,4264,"reading"
"2176",8,2,101,142,5579557,5584274,4717,"reading"
"2196",8,3,149,143,5589419,5594575,5156,"reading"
"2205",8,2,105,144,5597177,5601408,4231,"reading"
"22110",8,2,110,145,5603042,5605875,2833,"reading"
"2224",8,2,120,146,5607523,5610992,3469,"reading"
"2236",8,2,96,147,5612897,5616008,3111,"reading"
"2256",8,2,102,148,5621055,5626276,5221,"reading"
"2275",8,2,115,149,5630563,5634043,3480,"reading"
"2284",8,2,107,150,5635760,5639410,3650,"reading"
"2296",8,1,174,151,5640963,5645376,4413,"reading"
"2304",8,1,156,152,5647418,5652593,5175,"reading"
"2326",8,1,166,153,5658220,5666160,7940,"reading"
"2335",8,1,180,154,5668166,5672977,4811,"reading"
"2346",8,1,154,155,5674685,5680378,5693,"reading"
"2366",8,1,158,156,5684528,5689444,4916,"reading"
"2384",8,1,178,157,5693742,5698178,4436,"reading"
"2394",8,1,151,158,5699908,5704512,4604,"reading"
"24110",8,1,157,159,5709565,5715029,5464,"reading"
"2436",8,1,169,160,5719510,5723279,3769,"reading"
"2447",8,1,167,161,5726096,5730013,3917,"reading"
"2455",8,1,175,162,5731782,5734729,2947,"reading"
"2466",8,1,155,163,5736497,5741780,5283,"reading"
"2484",8,1,164,164,5754551,5760480,5929,"reading"
"2494",8,1,172,165,5762498,5767431,4933,"reading"
"2505",8,1,170,166,5769105,5773414,4309,"reading"
"2519",8,1,152,167,5775194,5780831,5637,"reading"
"2534",8,1,153,168,5786058,5789998,3940,"reading"
"2555",8,1,179,169,5794563,5798848,4285,"reading"
"2565",8,1,160,170,5800479,5805782,5303,"reading"
"2584",8,1,176,171,5811532,5816582,5050,"reading"
"2596",8,1,177,172,5818449,5825132,6683,"reading"
"2605",8,1,163,173,5826721,5831349,4628,"reading"
"2618",8,1,161,174,5833110,5838100,4990,"reading"
"2634",8,1,159,175,5843410,5848550,5140,"reading"
"2655",8,1,162,176,5853438,5858117,4679,"reading"
"2675",8,1,165,177,5862888,5868367,5479,"reading"
"2686",8,1,173,178,5869945,5877434,7489,"reading"
"2696",8,1,168,179,5879131,5884118,4987,"reading"
"2704",8,1,171,180,5885774,5890302,4528,"reading"
"1020",9,1,43,1,11977366,11982942,5576,"reading"
"1116",9,1,42,2,11985096,11988759,3663,"reading"
"138",9,1,52,3,11993609,11997191,3582,"reading"
"1411",9,1,32,4,11998806,12003541,4735,"reading"
"1624",9,1,46,5,12009514,12013624,4110,"reading"
"1718",9,1,40,6,12016390,12020692,4302,"reading"
"1918",9,1,54,7,12026127,12029425,3298,"reading"
"2018",9,1,50,8,12031877,12036376,4499,"reading"
"2118",9,1,34,9,12038650,12042426,3776,"reading"
"2320",9,1,55,10,12047651,12051395,3744,"reading"
"2420",9,1,58,11,12053681,12056793,3112,"reading"
"2520",9,1,36,12,12058971,12062260,3289,"reading"
"277",9,1,39,13,12066945,12069660,2715,"reading"
"296",9,1,53,14,12074341,12076710,2369,"reading"
"308",9,1,33,15,12078524,12082393,3869,"reading"
"326",9,1,37,16,12087497,12092527,5030,"reading"
"345",9,1,35,17,12099722,12102178,2456,"reading"
"364",9,1,45,18,12107589,12111645,4056,"reading"
"377",9,1,51,19,12113695,12117595,3900,"reading"
"385",9,1,31,20,12183938,12187531,3593,"reading"
"406",9,1,48,21,12192750,12195531,2781,"reading"
"416",9,1,49,22,12197176,12200931,3755,"reading"
"425",9,1,57,23,12202840,12205332,2492,"reading"
"437",9,1,38,24,12207066,12210498,3432,"reading"
"455",9,1,44,25,12215200,12217648,2448,"reading"
"466",9,1,60,26,12219629,12221865,2236,"reading"
"475",9,1,41,27,12223524,12226032,2508,"reading"
"497",9,1,59,28,12232787,12234782,1995,"reading"
"505",9,1,56,29,12237630,12239983,2353,"reading"
"514",9,1,47,30,12242544,12247282,4738,"reading"
"526",9,2,61,31,12249151,12253449,4298,"reading"
"545",9,2,62,32,12257458,12260050,2592,"reading"
"566",9,2,63,33,12264824,12267550,2726,"reading"
"585",9,3,22,34,12272107,12275300,3193,"reading"
"597",9,3,27,35,12278486,12281600,3114,"reading"
"606",9,2,89,36,12283512,12287802,4290,"reading"
"617",9,3,1,37,12290876,12295285,4409,"reading"
"638",9,3,26,38,12299481,12303051,3570,"reading"
"643",9,2,82,39,12304983,12308201,3218,"reading"
"657",9,2,65,40,12310020,12314018,3998,"reading"
"676",9,3,7,41,12321013,12324436,3423,"reading"
"695",9,3,14,42,12425101,12429272,4171,"reading"
"707",9,2,69,43,12431121,12434308,3187,"reading"
"725",9,2,68,44,12438512,12441925,3413,"reading"
"747",9,3,2,45,12446593,12449656,3063,"reading"
"767",9,3,23,46,12454547,12457690,3143,"reading"
"775",9,3,4,47,12460219,12462474,2255,"reading"
"797",9,3,18,48,12467140,12471007,3867,"reading"
"805",9,2,64,49,12472908,12475107,2199,"reading"
"823",9,2,87,50,12479998,12484458,4460,"reading"
"837",9,3,15,51,12486968,12491274,4306,"reading"
"845",9,2,78,52,12493685,12495809,2124,"reading"
"855",9,2,79,53,12498704,12501391,2687,"reading"
"864",9,2,67,54,12503286,12505625,2339,"reading"
"886",9,3,24,55,12515225,12519059,3834,"reading"
"896",9,3,29,56,12521255,12524876,3621,"reading"
"907",9,3,17,57,12526767,12530260,3493,"reading"
"917",9,2,70,58,12532196,12535393,3197,"reading"
"936",9,3,12,59,12541302,12543743,2441,"reading"
"958",9,2,83,60,12548830,12552460,3630,"reading"
"965",9,2,81,61,12555126,12557760,2634,"reading"
"976",9,3,10,62,12560364,12562626,2262,"reading"
"995",9,3,30,63,12567578,12570727,3149,"reading"
"1007",9,2,88,64,12573925,12577046,3121,"reading"
"10110",9,2,86,65,12578926,12581711,2785,"reading"
"1028",9,2,74,66,12583554,12585794,2240,"reading"
"1035",9,2,75,67,12588285,12590328,2043,"reading"
"1045",9,3,11,68,12592263,12595828,3565,"reading"
"1066",9,3,16,69,12602087,12604680,2593,"reading"
"1077",9,3,28,70,12606886,12608978,2092,"reading"
"1085",9,2,66,71,12611712,12614529,2817,"reading"
"1106",9,2,85,72,12619406,12622879,3473,"reading"
"1117",9,2,90,73,12624620,12627229,2609,"reading"
"1126",9,2,72,74,12628856,12631429,2573,"reading"
"1144",9,2,77,75,12636476,12638546,2070,"reading"
"1155",9,2,73,76,12641010,12644396,3386,"reading"
"1166",9,3,21,77,12646341,12650130,3789,"reading"
"1175",9,3,3,78,12651895,12655247,3352,"reading"
"1195",9,3,20,79,12659681,12661780,2099,"reading"
"1207",9,3,25,80,12663417,12665230,1813,"reading"
"1219",9,3,13,81,12667951,12672381,4430,"reading"
"1227",9,3,8,82,12674173,12677264,3091,"reading"
"1246",9,2,84,83,12681984,12684681,2697,"reading"
"1255",9,3,5,84,12686346,12688714,2368,"reading"
"1276",9,2,71,85,12692660,12694481,1821,"reading"
"1295",9,3,9,86,12698809,12701598,2789,"reading"
"1314",9,3,6,87,12707375,12710132,2757,"reading"
"1336",9,3,19,88,12714749,12717066,2317,"reading"
"1345",9,2,76,89,12718794,12720799,2005,"reading"
"1357",9,2,80,90,12722672,12725316,2644,"reading"
"1457",9,1,121,91,12895992,12898556,2564,"zString"
"1478",9,1,132,92,12902231,12906055,3824,"zString"
"1498",9,1,134,93,12910033,12913239,3206,"zString"
"1501",9,1,139,94,12914995,12917973,2978,"zString"
"1517",9,1,133,95,12919691,12922572,2881,"zString"
"1525",9,1,150,96,12924468,12927906,3438,"zString"
"1534",9,1,123,97,12929412,12932123,2711,"zString"
"1557",9,1,135,98,12936634,12939857,3223,"zString"
"1566",9,1,147,99,12941570,12945223,3653,"zString"
"1576",9,1,127,100,12947022,12950274,3252,"zString"
"1595",9,1,131,101,12954015,12957408,3393,"zString"
"16112",9,1,137,102,12961148,12964174,3026,"zString"
"1625",9,1,143,103,12965840,12969358,3518,"zString"
"1636",9,1,140,104,12971267,12974625,3358,"zString"
"1646",9,1,148,105,12976268,12980441,4173,"zString"
"1655",9,1,124,106,12982771,12986075,3304,"zString"
"1675",9,1,136,107,12990010,12993008,2998,"zString"
"1687",9,1,145,108,12994615,12997608,2993,"zString"
"1694",9,1,146,109,12999505,13002359,2854,"zString"
"1706",9,1,122,110,13003929,13006875,2946,"zString"
"1727",9,1,141,111,13010581,13013211,2630,"zString"
"1736",9,1,129,112,13015884,13018609,2725,"zString"
"1756",9,1,138,113,13023493,13025793,2300,"zString"
"1767",9,1,125,114,13027653,13030310,2657,"zString"
"1784",9,1,126,115,13035793,13038427,2634,"zString"
"1806",9,1,149,116,13042781,13045610,2829,"zString"
"1819",9,1,142,117,13047598,13050527,2929,"zString"
"1824",9,1,130,118,13052642,13055511,2869,"zString"
"1846",9,1,144,119,13059168,13062711,3543,"zString"
"1856",9,1,128,120,13064640,13068011,3371,"zString"
"1878",9,2,151,121,13071705,13075879,4174,"zString"
"1896",9,2,152,122,13079512,13082561,3049,"zString"
"1919",9,2,153,123,13086353,13088411,2058,"zString"
"1936",9,3,110,124,13092424,13094529,2105,"zString"
"1945",9,3,99,125,13096683,13099696,3013,"zString"
"1964",9,3,113,126,13105080,13107579,2499,"zString"
"1978",9,3,104,127,13109867,13112330,2463,"zString"
"1985",9,3,92,128,13114151,13117179,3028,"zString"
"2007",9,2,173,129,13121932,13125046,3114,"zString"
"2019",9,3,100,130,13126930,13129513,2583,"zString"
"2035",9,3,114,131,13133611,13135563,1952,"zString"
"2048",9,3,112,132,13173763,13176781,3018,"zString"
"2056",9,3,97,133,13178505,13180264,1759,"zString"
"2077",9,3,108,134,13184595,13186749,2154,"zString"
"2084",9,2,154,135,13188751,13191199,2448,"zString"
"2107",9,3,119,136,13195043,13198732,3689,"zString"
"2119",9,3,91,137,13200679,13203399,2720,"zString"
"2134",9,2,166,138,13207962,13210184,2222,"zString"
"2147",9,2,167,139,13212067,13214766,2699,"zString"
"2155",9,3,101,140,13216451,13218033,1582,"zString"
"2177",9,2,174,141,13222369,13224966,2597,"zString"
"2185",9,3,120,142,13226850,13228916,2066,"zString"
"2197",9,2,169,143,13230765,13233250,2485,"zString"
"2206",9,2,165,144,13235016,13237900,2884,"zString"
"22111",9,2,179,145,13239638,13243684,4046,"zString"
"2225",9,2,163,146,13245239,13247901,2662,"zString"
"2237",9,3,118,147,13250194,13252734,2540,"zString"
"2245",9,3,117,148,13254359,13256651,2292,"zString"
"2257",9,2,160,149,13258363,13261417,3054,"zString"
"2276",9,3,106,150,13267393,13269968,2575,"zString"
"2285",9,3,94,151,13271775,13274301,2526,"zString"
"2305",9,3,96,152,13278336,13281368,3032,"zString"
"2327",9,2,162,153,13284970,13287402,2432,"zString"
"2347",9,3,98,154,13291420,13293870,2450,"zString"
"2367",9,3,105,155,13298198,13300486,2288,"zString"
"2374",9,3,93,156,13302168,13304136,1968,"zString"
"2395",9,2,164,157,13308671,13311536,2865,"zString"
"2404",9,3,116,158,13313348,13316004,2656,"zString"
"24111",9,2,172,159,13317654,13321186,3532,"zString"
"2423",9,3,102,160,13323054,13326437,3383,"zString"
"2448",9,2,177,161,13330595,13333319,2724,"zString"
"2456",9,2,176,162,13335049,13338153,3104,"zString"
"2467",9,2,180,163,13340625,13343954,3329,"zString"
"2475",9,2,170,164,13345617,13348554,2937,"zString"
"2485",9,2,156,165,13350471,13353687,3216,"zString"
"2506",9,2,171,166,13358779,13361804,3025,"zString"
"25110",9,2,175,167,13363561,13367071,3510,"zString"
"2525",9,3,109,168,13368912,13371155,2243,"zString"
"2535",9,3,115,169,13372635,13375740,3105,"zString"
"2546",9,3,107,170,13377141,13379806,2665,"zString"
"2556",9,2,158,171,13381578,13384355,2777,"zString"
"2576",9,2,157,172,13388393,13390788,2395,"zString"
"2597",9,3,111,173,13394895,13397656,2761,"zString"
"2606",9,2,155,174,13399294,13401839,2545,"zString"
"2626",9,2,159,175,13405616,13408323,2707,"zString"
"2646",9,2,161,176,13412096,13415190,3094,"zString"
"2664",9,2,168,177,13419042,13422190,3148,"zString"
"2676",9,3,95,178,13424577,13427423,2846,"zString"
"2697",9,3,103,179,13431349,13434357,3008,"zString"
"2705",9,2,178,180,13436260,13438790,2530,"zString"
"1029",10,1,13,1,465322,468233,2911,"zString"
"1118",10,1,2,2,470437,474632,4195,"zString"
"139",10,1,14,3,479183,481182,1999,"zString"
"1412",10,1,20,4,483401,487966,4565,"zString"
"1518",10,1,12,5,489792,493249,3457,"zString"
"1719",10,1,4,6,497490,501000,3510,"zString"
"1920",10,1,16,7,506352,510967,4615,"zString"
"2020",10,1,9,8,513578,516216,2638,"zString"
"2220",10,1,15,9,520401,524400,3999,"zString"
"2328",10,1,5,10,527991,530517,2526,"zString"
"2526",10,1,10,11,534422,537334,2912,"zString"
"278",10,1,1,12,541156,544368,3212,"zString"
"297",10,1,19,13,548260,554552,6292,"zString"
"309",10,1,25,14,557705,561919,4214,"zString"
"316",10,1,24,15,564869,570936,6067,"zString"
"327",10,1,26,16,573399,577753,4354,"zString"
"335",10,1,8,17,579734,584102,4368,"zString"
"356",10,1,3,18,588028,591653,3625,"zString"
"378",10,1,30,19,595459,599286,3827,"zString"
"386",10,1,27,20,601487,605653,4166,"zString"
"397",10,1,22,21,608215,611604,3389,"zString"
"407",10,1,21,22,613463,620804,7341,"zString"
"417",10,1,23,23,623476,626704,3228,"zString"
"426",10,1,28,24,630823,634804,3981,"zString"
"438",10,1,6,25,636394,640354,3960,"zString"
"456",10,1,7,26,644502,648038,3536,"zString"
"476",10,1,18,27,652231,655404,3173,"zString"
"486",10,1,29,28,657334,661188,3854,"zString"
"498",10,1,11,29,662696,667055,4359,"zString"
"515",10,1,17,30,671228,674422,3194,"zString"
"527",10,2,31,31,676192,680856,4664,"zString"
"546",10,2,32,32,686623,689206,2583,"zString"
"567",10,2,33,33,693322,696406,3084,"zString"
"586",10,3,70,34,701055,705073,4018,"zString"
"607",10,3,79,35,708995,712157,3162,"zString"
"618",10,2,42,36,714493,716957,2464,"zString"
"639",10,3,75,37,723416,727057,3641,"zString"
"644",10,3,69,38,728923,731059,2136,"zString"
"665",10,2,34,39,734969,738474,3505,"zString"
"686",10,2,56,40,742825,745674,2849,"zString"
"696",10,3,85,41,747501,750308,2807,"zString"
"708",10,2,59,42,892948,896763,3815,"zString"
"716",10,2,40,43,899689,902380,2691,"zString"
"735",10,3,86,44,907319,909680,2361,"zString"
"748",10,2,38,45,912049,914780,2731,"zString"
"768",10,3,65,46,919082,921665,2583,"zString"
"785",10,3,71,47,927314,930014,2700,"zString"
"806",10,2,37,48,934750,936715,1965,"zString"
"824",10,3,88,49,940957,943631,2674,"zString"
"838",10,3,63,50,945887,948832,2945,"zString"
"856",10,2,49,51,952846,955282,2436,"zString"
"865",10,2,50,52,957661,960448,2787,"zString"
"876",10,3,72,53,962455,965899,3444,"zString"
"897",10,2,53,54,969520,972382,2862,"zString"
"908",10,2,48,55,974053,977432,3379,"zString"
"918",10,3,80,56,979328,982266,2938,"zString"
"927",10,3,82,57,984056,986982,2926,"zString"
"937",10,3,67,58,988732,990949,2217,"zString"
"959",10,2,47,59,996572,999533,2961,"zString"
"966",10,2,44,60,1001578,1004267,2689,"zString"
"977",10,3,68,61,1006490,1009984,3494,"zString"
"996",10,3,76,62,1013871,1017833,3962,"zString"
"1008",10,2,35,63,1020229,1023184,2955,"zString"
"10210",10,2,60,64,1027424,1033134,5710,"zString"
"1036",10,3,78,65,1035264,1038552,3288,"zString"
"1046",10,3,73,66,1040469,1042684,2215,"zString"
"1054",10,3,61,67,1044421,1047501,3080,"zString"
"1078",10,3,84,68,1051548,1054702,3154,"zString"
"1086",10,2,58,69,1056921,1059685,2764,"zString"
"1095",10,3,87,70,1061498,1066285,4787,"zString"
"1107",10,3,66,71,1068357,1071602,3245,"zString"
"1127",10,3,62,72,1076120,1078352,2232,"zString"
"1145",10,3,74,73,1083032,1086971,3939,"zString"
"1156",10,3,83,74,1089345,1092753,3408,"zString"
"1167",10,2,57,75,1094990,1098221,3231,"zString"
"1176",10,3,81,76,1100341,1103453,3112,"zString"
"1186",10,2,46,77,1105699,1108487,2788,"zString"
"1196",10,3,64,78,1110620,1113720,3100,"zString"
"12110",10,2,45,79,1117499,1120354,2855,"zString"
"1228",10,2,54,80,1122630,1126488,3858,"zString"
"1234",10,2,51,81,1127967,1132737,4770,"zString"
"1247",10,3,90,82,1134598,1137288,2690,"zString"
"1256",10,2,41,83,1139221,1142438,3217,"zString"
"1277",10,2,39,84,1146421,1150805,4384,"zString"
"1296",10,2,55,85,1154441,1157488,3047,"zString"
"1307",10,2,43,86,1159667,1163322,3655,"zString"
"1315",10,3,77,87,1165325,1168005,2680,"zString"
"1326",10,2,52,88,1169605,1173606,4001,"zString"
"1337",10,2,36,89,1175058,1179056,3998,"zString"
"1358",10,3,89,90,1183259,1187858,4599,"zString"
"1458",10,1,107,91,1422649,1426266,3617,"reading"
"1462",10,1,95,92,1428039,1431050,3011,"reading"
"1481",10,1,117,93,1436288,1438450,2162,"reading"
"1499",10,1,116,94,1440452,1443151,2699,"reading"
"1502",10,1,104,95,1445324,1448967,3643,"reading"
"1519",10,1,115,96,1450544,1453151,2607,"reading"
"1526",10,1,100,97,1455184,1458967,3783,"reading"
"1544",10,1,112,98,1464663,1467818,3155,"reading"
"1558",10,1,111,99,1470046,1474151,4105,"reading"
"1567",10,1,114,100,1475826,1479768,3942,"reading"
"1577",10,1,102,101,1481968,1485418,3450,"reading"
"1596",10,1,109,102,1492341,1495321,2980,"reading"
"1606",10,1,113,103,1497365,1500452,3087,"reading"
"16113",10,1,106,104,1501985,1505402,3417,"reading"
"1626",10,1,91,105,1508390,1511119,2729,"reading"
"1647",10,1,99,106,1516500,1519086,2586,"reading"
"1667",10,1,120,107,1524087,1527320,3233,"reading"
"1676",10,1,94,108,1529039,1532737,3698,"reading"
"1695",10,1,92,109,1538532,1541120,2588,"reading"
"17110",10,1,97,110,1546253,1548487,2234,"reading"
"1737",10,1,108,111,1555380,1561688,6308,"reading"
"1747",10,1,93,112,1563778,1569338,5560,"reading"
"1768",10,1,103,113,1574657,1579038,4381,"reading"
"1776",10,1,96,114,1580773,1582971,2198,"reading"
"1797",10,1,105,115,1587890,1591423,3533,"reading"
"1807",10,1,98,116,1593671,1596706,3035,"reading"
"1825",10,1,110,117,1602401,1605106,2705,"reading"
"1836",10,1,118,118,1608037,1612439,4402,"reading"
"1847",10,1,101,119,1617062,1621206,4144,"reading"
"1865",10,1,119,120,1626106,1630106,4000,"reading"
"1879",10,2,121,121,1631817,1635490,3673,"reading"
"1897",10,2,122,122,1640203,1643640,3437,"reading"
"19110",10,2,123,123,1648597,1651907,3310,"reading"
"1937",10,2,140,124,1657963,1660941,2978,"reading"
"1946",10,2,141,125,1662812,1666375,3563,"reading"
"1956",10,2,139,126,1668163,1671324,3161,"reading"
"1965",10,3,155,127,1673098,1678091,4993,"reading"
"1986",10,3,156,128,1683269,1687092,3823,"reading"
"2008",10,2,146,129,1695600,1700059,4459,"reading"
"20110",10,3,159,130,1702127,1706142,4015,"reading"
"2036",10,3,175,131,1711683,1714292,2609,"reading"
"2049",10,3,166,132,1855964,1860631,4667,"reading"
"2057",10,2,137,133,1864366,1866947,2581,"reading"
"2066",10,3,154,134,1884555,1888067,3512,"reading"
"2085",10,3,161,135,1893673,1897400,3727,"reading"
"2108",10,2,145,136,1904485,1908201,3716,"reading"
"21110",10,3,171,137,1910197,1913685,3488,"reading"
"2126",10,2,150,138,1915761,1919552,3791,"reading"
"2135",10,2,126,139,1921751,1925968,4217,"reading"
"2156",10,2,125,140,1933215,1936052,2837,"reading"
"2178",10,3,167,141,1941616,1944953,3337,"reading"
"2186",10,3,165,142,1947389,1951553,4164,"reading"
"2198",10,3,153,143,1953548,1956553,3005,"reading"
"22112",10,2,127,144,1960817,1963969,3152,"reading"
"2238",10,2,133,145,1968899,1972303,3404,"reading"
"2246",10,3,173,146,1974973,1978371,3398,"reading"
"2258",10,2,128,147,1980505,1984221,3716,"reading"
"2277",10,2,144,148,1989473,1993721,4248,"reading"
"2286",10,3,174,149,1995715,1999104,3389,"reading"
"2297",10,3,157,150,2001084,2004938,3854,"reading"
"23111",10,3,164,151,2010736,2014421,3685,"reading"
"2329",10,2,134,152,2016428,2019189,2761,"reading"
"2336",10,3,176,153,2021831,2024855,3024,"reading"
"2348",10,2,132,154,2026994,2030105,3111,"reading"
"2368",10,2,147,155,2035103,2038555,3452,"reading"
"2375",10,2,149,156,2040561,2044356,3795,"reading"
"2385",10,3,160,157,2046327,2050106,3779,"reading"
"2405",10,3,158,158,2056845,2060340,3495,"reading"
"2424",10,3,169,159,2064994,2069307,4313,"reading"
"2437",10,3,177,160,2071657,2075257,3600,"reading"
"2449",10,2,142,161,2077052,2080574,3522,"reading"
"2457",10,3,172,162,2083179,2086374,3195,"reading"
"2468",10,3,152,163,2088815,2093241,4426,"reading"
"2486",10,2,148,164,2098939,2101441,2502,"reading"
"2495",10,3,170,165,2103557,2108308,4751,"reading"
"2507",10,2,124,166,2110598,2113241,2643,"reading"
"2527",10,3,179,167,2118827,2121392,2565,"reading"
"2536",10,2,143,168,2124567,2127678,3111,"reading"
"2547",10,2,131,169,2129965,2132576,2611,"reading"
"2566",10,3,163,170,2137874,2140975,3101,"reading"
"2577",10,2,129,171,2142717,2145893,3176,"reading"
"2598",10,2,138,172,2151585,2155311,3726,"reading"
"2607",10,3,162,173,2157316,2159976,2660,"reading"
"2627",10,3,178,174,2164694,2167744,3050,"reading"
"2635",10,3,151,175,2170218,2173326,3108,"reading"
"2656",10,2,135,176,2178439,2181177,2738,"reading"
"2665",10,2,130,177,2183171,2187677,4506,"reading"
"2687",10,3,180,178,2192173,2194911,2738,"reading"
"2698",10,2,136,179,2196840,2199962,3122,"reading"
"2706",10,3,168,180,2201997,2205061,3064,"reading"
"1030",11,2,1,1,3375808,3381516,5708,"reading"
"1220",11,2,2,2,3385919,3392400,6481,"reading"
"1413",11,2,3,3,3398288,3403050,4762,"reading"
"1627",11,3,34,4,3408415,3413534,5119,"reading"
"1820",11,3,48,5,3418075,3423735,5660,"reading"
"1925",11,3,36,6,3426069,3429768,3699,"reading"
"2120",11,2,19,7,3434366,3439368,5002,"reading"
"2226",11,2,20,8,3442251,3445719,3468,"reading"
"2330",11,3,49,9,3447663,3451635,3972,"reading"
"2425",11,2,23,10,3453354,3457185,3831,"reading"
"2528",11,2,16,11,3458997,3463669,4672,"reading"
"2619",11,3,52,12,3465644,3471253,5609,"reading"
"279",11,3,33,13,3473374,3478686,5312,"reading"
"298",11,3,51,14,3485285,3492303,7018,"reading"
"3010",11,3,38,15,3495345,3500604,5259,"reading"
"328",11,2,22,16,3506190,3510437,4247,"reading"
"336",11,2,11,17,3512523,3517437,4914,"reading"
"357",11,3,40,18,3523280,3527771,4491,"reading"
"379",11,3,47,19,3532722,3537738,5016,"reading"
"387",11,2,29,20,3539674,3544488,4814,"reading"
"398",11,2,4,21,3546371,3551939,5568,"reading"
"418",11,3,50,22,3559200,3565406,6206,"reading"
"427",11,2,25,23,3567337,3571189,3852,"reading"
"439",11,2,18,24,3573379,3577173,3794,"reading"
"446",11,3,54,25,3579500,3583773,4273,"reading"
"457",11,2,15,26,3585746,3589940,4194,"reading"
"467",11,2,5,27,3592052,3595590,3538,"reading"
"487",11,3,46,28,3599756,3604674,4918,"reading"
"499",11,3,42,29,3606206,3609991,3785,"reading"
"516",11,3,53,30,3616349,3622641,6292,"reading"
"528",11,2,17,31,3624642,3629591,4949,"reading"
"534",11,3,35,32,3632118,3636008,3890,"reading"
"553",11,2,30,33,3641276,3644792,3516,"reading"
"568",11,2,9,34,3646935,3650025,3090,"reading"
"587",11,3,45,35,3654576,3657659,3083,"reading"
"598",11,2,24,36,3659417,3663259,3842,"reading"
"608",11,2,26,37,3664946,3668093,3147,"reading"
"619",11,2,6,38,3669879,3673393,3514,"reading"
"6310",11,3,44,39,3679281,3684043,4762,"reading"
"645",11,2,27,40,3686140,3689777,3637,"reading"
"658",11,2,12,41,3692095,3695560,3465,"reading"
"677",11,3,32,42,3858426,3866733,8307,"reading"
"697",11,2,14,43,3875461,3879366,3905,"reading"
"709",11,3,56,44,3882423,3886750,4327,"reading"
"717",11,3,57,45,3892167,3896850,4683,"reading"
"726",11,3,60,46,3914176,3918868,4692,"reading"
"736",11,3,58,47,3920473,3924852,4379,"reading"
"749",11,2,8,48,3926710,3931668,4958,"reading"
"769",11,3,37,49,3937152,3941035,3883,"reading"
"786",11,3,43,50,3945823,3949536,3713,"reading"
"798",11,2,21,51,3951739,3956752,5013,"reading"
"807",11,3,55,52,3958325,3961303,2978,"reading"
"817",11,2,13,53,3963240,3967303,4063,"reading"
"825",11,3,39,54,3969820,3976486,6666,"reading"
"846",11,3,41,55,3980926,3984654,3728,"reading"
"866",11,2,28,56,3989785,3993071,3286,"reading"
"877",11,2,7,57,3995330,3998737,3407,"reading"
"898",11,3,59,58,4003372,4007654,4282,"reading"
"909",11,3,31,59,4009253,4015621,6368,"reading"
"928",11,2,10,60,4021358,4024105,2747,"reading"
"946",11,1,69,61,4028519,4032822,4303,"reading"
"967",11,1,82,62,4037571,4041922,4351,"reading"
"978",11,1,79,63,4043822,4048339,4517,"reading"
"987",11,1,88,64,4050178,4053289,3111,"reading"
"997",11,1,67,65,4055138,4059473,4335,"reading"
"10111",11,1,86,66,4065519,4070056,4537,"reading"
"10211",11,1,84,67,4071723,4075723,4000,"reading"
"1037",11,1,80,68,4077827,4081873,4046,"reading"
"1047",11,1,83,69,4083818,4087073,3255,"reading"
"1055",11,1,76,70,4088995,4091390,2395,"reading"
"1067",11,1,63,71,4093258,4097257,3999,"reading"
"1087",11,1,89,72,4102139,4106974,4835,"reading"
"1096",11,1,66,73,4108939,4112991,4052,"reading"
"1119",11,1,68,74,4117904,4121708,3804,"reading"
"1138",11,1,81,75,4126214,4130341,4127,"reading"
"1146",11,1,65,76,4132137,4135442,3305,"reading"
"1168",11,1,87,77,4140339,4143242,2903,"reading"
"1177",11,1,62,78,4145670,4148426,2756,"reading"
"1197",11,1,75,79,4153202,4156926,3724,"reading"
"1208",11,1,64,80,4158734,4162593,3859,"reading"
"1229",11,1,70,81,4167297,4171076,3779,"reading"
"1248",11,1,85,82,4176429,4180927,4498,"reading"
"1257",11,1,73,83,4187001,4190977,3976,"reading"
"1267",11,1,72,84,4193202,4196461,3259,"reading"
"1286",11,1,71,85,4201577,4205211,3634,"reading"
"1308",11,1,90,86,4210861,4214961,4100,"reading"
"1316",11,1,61,87,4216647,4220161,3514,"reading"
"1338",11,1,74,88,4225911,4229962,4051,"reading"
"1346",11,1,78,89,4231901,4234462,2561,"reading"
"1359",11,1,77,90,4236243,4239979,3736,"reading"
"1459",11,2,91,91,4475951,4479120,3169,"zString"
"1479",11,2,92,92,4512575,4516307,3732,"zString"
"14910",11,2,93,93,4520313,4523206,2893,"zString"
"15110",11,3,134,94,4528063,4530656,2593,"zString"
"1527",11,2,113,95,4533669,4536207,2538,"zString"
"1535",11,3,148,96,4538511,4541857,3346,"zString"
"1545",11,3,128,97,4544854,4548207,3353,"zString"
"1568",11,2,107,98,4552724,4555607,2883,"zString"
"1578",11,2,95,99,4559319,4563274,3955,"zString"
"1597",11,2,111,100,4568126,4571541,3415,"zString"
"1607",11,2,94,101,4574625,4576991,2366,"zString"
"1628",11,2,105,102,4581135,4583742,2607,"zString"
"1637",11,2,106,103,4585901,4588891,2990,"zString"
"1648",11,3,146,104,4591244,4594292,3048,"zString"
"1656",11,3,150,105,4596782,4599759,2977,"zString"
"1668",11,2,104,106,4601521,4605109,3588,"zString"
"1677",11,2,110,107,4608646,4611759,3113,"zString"
"1688",11,2,100,108,4614719,4618843,4124,"zString"
"1707",11,2,118,109,4623628,4626276,2648,"zString"
"17111",11,3,149,110,4628682,4632710,4028,"zString"
"1728",11,3,122,111,4635261,4638110,2849,"zString"
"1748",11,2,117,112,4643036,4645144,2108,"zString"
"1757",11,3,131,113,4648671,4651794,3123,"zString"
"1777",11,3,125,114,4657142,4660961,3819,"zString"
"1798",11,3,141,115,4665520,4669028,3508,"zString"
"1808",11,3,142,116,4672113,4675345,3232,"zString"
"18110",11,2,103,117,4678615,4682295,3680,"zString"
"1826",11,2,112,118,4686349,4690062,3713,"zString"
"1837",11,2,97,119,4692343,4695195,2852,"zString"
"1857",11,3,132,120,4701741,4706013,4272,"zString"
"18710",11,2,109,121,4709908,4711913,2005,"zString"
"1884",11,3,139,122,4713915,4716946,3031,"zString"
"1898",11,2,119,123,4719273,4722597,3324,"zString"
"1904",11,2,98,124,4725591,4729463,3872,"zString"
"1926",11,3,143,125,4733616,4737664,4048,"zString"
"1938",11,3,140,126,4739714,4744414,4700,"zString"
"1947",11,3,127,127,4746611,4750414,3803,"zString"
"1966",11,3,130,128,4754320,4759498,5178,"zString"
"1987",11,3,136,129,4764048,4767998,3950,"zString"
"1996",11,3,124,130,4770524,4774748,4224,"zString"
"20111",11,3,121,131,4779648,4782615,2967,"zString"
"2037",11,3,126,132,4986931,4990222,3291,"zString"
"2058",11,2,120,133,4994690,4998156,3466,"zString"
"2067",11,3,145,134,5001061,5003806,2745,"zString"
"2078",11,3,144,135,5006361,5010190,3829,"zString"
"2086",11,3,147,136,5012206,5015740,3534,"zString"
"2097",11,2,115,137,5017580,5020356,2776,"zString"
"2109",11,3,138,138,5022378,5025357,2979,"zString"
"21111",11,3,133,139,5027169,5030423,3254,"zString"
"2127",11,3,129,140,5032136,5035124,2988,"zString"
"2148",11,2,116,141,5039023,5042974,3951,"zString"
"2157",11,2,101,142,5045436,5048307,2871,"zString"
"2179",11,2,114,143,5052803,5056374,3571,"zString"
"2187",11,3,135,144,5058403,5062692,4289,"zString"
"2199",11,2,96,145,5064893,5068525,3632,"zString"
"22113",11,3,123,146,5073030,5076609,3579,"zString"
"2239",11,2,108,147,5080396,5083659,3263,"zString"
"2247",11,2,99,148,5085800,5089092,3292,"zString"
"2265",11,2,102,149,5093718,5097409,3691,"zString"
"2287",11,3,137,150,5101706,5105092,3386,"zString"
"2298",11,1,173,151,5106934,5110176,3242,"zString"
"2306",11,1,167,152,5112772,5117226,4454,"zString"
"23112",11,1,162,153,5119187,5122493,3306,"zString"
"2337",11,1,159,154,5126306,5129710,3404,"zString"
"2355",11,1,161,155,5133741,5136794,3053,"zString"
"2376",11,1,151,156,5140794,5144044,3250,"zString"
"2396",11,1,154,157,5148129,5151311,3182,"zString"
"24112",11,1,178,158,5155122,5158094,2972,"zString"
"2426",11,1,172,159,5160195,5164195,4000,"zString"
"2438",11,1,176,160,5166731,5171028,4297,"zString"
"24410",11,1,177,161,5173398,5178495,5097,"zString"
"2458",11,1,157,162,5182396,5186412,4016,"zString"
"2476",11,1,156,163,5191694,5196029,4335,"zString"
"2496",11,1,152,164,5200132,5204279,4147,"zString"
"25111",11,1,174,165,5208680,5211797,3117,"zString"
"2529",11,1,171,166,5214010,5218148,4138,"zString"
"2537",11,1,155,167,5220139,5223980,3841,"zString"
"2557",11,1,169,168,5228096,5230830,2734,"zString"
"2567",11,1,160,169,5233411,5237180,3769,"zString"
"2585",11,1,175,170,5241909,5245431,3522,"zString"
"2599",11,1,180,171,5247797,5251714,3917,"zString"
"2608",11,1,165,172,5255652,5258697,3045,"zString"
"26110",11,1,164,173,5263419,5268098,4679,"zString"
"2628",11,1,168,174,5271177,5276832,5655,"zString"
"2636",11,1,179,175,5279668,5283182,3514,"zString"
"2647",11,1,166,176,5284918,5288899,3981,"zString"
"2657",11,1,163,177,5290639,5295482,4843,"zString"
"2666",11,1,158,178,5299199,5302316,3117,"zString"
"2688",11,1,153,179,5306314,5309649,3335,"zString"
"2707",11,1,170,180,5313886,5318133,4247,"zString"
"1414",12,2,61,1,7172905,7176647,3742,"zString"
"1629",12,2,62,2,7181030,7184547,3517,"zString"
"1827",12,2,63,3,7187997,7190914,2917,"zString"
"2027",12,3,20,4,7196640,7199814,3174,"zString"
"2128",12,2,71,5,7201457,7204731,3274,"zString"
"2338",12,2,88,6,7211183,7214232,3049,"zString"
"2427",12,2,83,7,7217161,7220332,3171,"zString"
"2530",12,2,65,8,7222414,7225698,3284,"zString"
"2710",12,2,72,9,7229408,7232499,3091,"zString"
"299",12,3,7,10,7236936,7240532,3596,"zString"
"317",12,3,14,11,7244846,7247449,2603,"zString"
"329",12,3,13,12,7249033,7252033,3000,"zString"
"337",12,2,86,13,7254221,7256966,2745,"zString"
"346",12,3,9,14,7259177,7261433,2256,"zString"
"365",12,3,19,15,7265202,7268833,3631,"zString"
"3710",12,2,74,16,7270491,7274366,3875,"zString"
"388",12,2,80,17,7276784,7281700,4916,"zString"
"399",12,2,64,18,7283733,7288150,4417,"zString"
"419",12,3,3,19,7293622,7296868,3246,"zString"
"4310",12,2,84,20,7300594,7303917,3323,"zString"
"447",12,2,82,21,7306174,7310351,4177,"zString"
"458",12,2,69,22,7312440,7315451,3011,"zString"
"477",12,3,25,23,7319043,7321418,2375,"zString"
"488",12,2,67,24,7323131,7326085,2954,"zString"
"506",12,3,16,25,7331076,7335485,4409,"zString"
"517",12,2,78,26,7337283,7341119,3836,"zString"
"529",12,2,70,27,7342886,7346652,3766,"zString"
"547",12,3,8,28,7350523,7354052,3529,"zString"
"569",12,2,85,29,7358385,7361703,3318,"zString"
"574",12,2,68,30,7364231,7368253,4022,"zString"
"599",12,3,28,31,7373214,7376787,3573,"zString"
"609",12,2,73,32,7379762,7383003,3241,"zString"
"6110",12,3,18,33,7385064,7387737,2673,"zString"
"624",12,2,79,34,7389333,7392604,3271,"zString"
"6311",12,2,90,35,7394460,7397021,2561,"zString"
"646",12,3,15,36,7398835,7402205,3370,"zString"
"659",12,3,4,37,7404219,7408171,3952,"zString"
"678",12,3,29,38,7412093,7415155,3062,"zString"
"687",12,2,76,39,7417527,7420655,3128,"zString"
"698",12,3,12,40,7422451,7424672,2221,"zString"
"718",12,2,77,41,7430227,7432405,2178,"zString"
"727",12,2,87,42,7572889,7576094,3205,"zString"
"737",12,3,24,43,7579012,7581827,2815,"zString"
"7410",12,2,75,44,7584516,7587095,2579,"zString"
"755",12,3,27,45,7589735,7592578,2843,"zString"
"7610",12,3,26,46,7594977,7598295,3318,"zString"
"776",12,3,10,47,7600442,7602295,1853,"zString"
"799",12,2,66,48,7606282,7608428,2146,"zString"
"818",12,3,2,49,7612458,7615162,2704,"zString"
"839",12,3,23,50,7618552,7620845,2293,"zString"
"847",12,2,89,51,7622801,7626145,3344,"zString"
"857",12,3,6,52,7628092,7630746,2654,"zString"
"878",12,3,17,53,7634193,7637647,3454,"zString"
"887",12,3,22,54,7639211,7641579,2368,"zString"
"899",12,3,11,55,7643679,7646797,3118,"zString"
"919",12,3,1,56,7651219,7653647,2428,"zString"
"938",12,3,5,57,7657179,7659463,2284,"zString"
"9510",12,2,81,58,7663447,7665547,2100,"zString"
"968",12,3,30,59,7667367,7670064,2697,"zString"
"979",12,3,21,60,7671981,7675214,3233,"zString"
"988",12,1,59,61,7677371,7680398,3027,"zString"
"998",12,1,51,62,7682775,7686998,4223,"zString"
"1009",12,1,58,63,7688490,7692215,3725,"zString"
"10112",12,1,46,64,7693848,7697582,3734,"zString"
"10212",12,1,42,65,7699489,7702115,2626,"zString"
"1048",12,1,48,66,7705747,7708765,3018,"zString"
"1056",12,1,50,67,7711392,7714299,2907,"zString"
"1068",12,1,34,68,7716457,7720799,4342,"zString"
"1088",12,1,54,69,7726255,7728982,2727,"zString"
"1097",12,1,45,70,7731194,7734116,2922,"zString"
"1108",12,1,31,71,7736817,7740383,3566,"zString"
"1128",12,1,37,72,7744474,7746900,2426,"zString"
"1147",12,1,53,73,7751265,7754283,3018,"zString"
"1157",12,1,55,74,7756159,7758367,2208,"zString"
"1169",12,1,35,75,7760731,7763950,3219,"zString"
"1187",12,1,49,76,7768102,7770751,2649,"zString"
"1198",12,1,43,77,7772750,7775817,3067,"zString"
"1209",12,1,44,78,7777457,7780051,2594,"zString"
"12111",12,1,57,79,7782193,7785318,3125,"zString"
"12210",12,1,52,80,7787447,7790785,3338,"zString"
"1235",12,1,38,81,7792318,7794752,2434,"zString"
"1258",12,1,33,82,7799190,7802968,3778,"zString"
"1278",12,1,60,83,7806545,7809602,3057,"zString"
"1287",12,1,41,84,7811230,7814852,3622,"zString"
"1309",12,1,32,85,7819537,7823136,3599,"zString"
"1327",12,1,47,86,7827977,7832570,4593,"zString"
"1339",12,1,39,87,7834434,7838053,3619,"zString"
"13510",12,1,56,88,7842224,7845304,3080,"zString"
"1361",12,1,40,89,7847849,7852053,4204,"zString"
"1381",12,1,36,90,7855485,7858320,2835,"zString"
"14911",12,2,151,91,8069654,8076261,6607,"reading"
"15111",12,2,152,92,8082079,8088695,6616,"reading"
"1536",12,2,153,93,8094087,8098262,4175,"reading"
"1559",12,3,112,94,8102680,8108278,5598,"reading"
"1569",12,2,175,95,8110931,8114229,3298,"reading"
"1579",12,2,155,96,8116686,8121846,5160,"reading"
"1598",12,2,168,97,8127904,8133079,5175,"reading"
"1608",12,2,174,98,8134938,8138863,3925,"reading"
"16114",12,3,113,99,8140730,8145197,4467,"reading"
"16210",12,3,98,100,8147082,8150863,3781,"reading"
"1649",12,3,110,101,8155820,8159664,3844,"reading"
"1657",12,3,95,102,8162019,8164997,2978,"reading"
"1678",12,2,176,103,8169325,8175581,6256,"reading"
"1689",12,3,111,104,8177459,8180264,2805,"reading"
"1696",12,2,173,105,8182597,8185831,3234,"reading"
"1708",12,3,101,106,8212120,8214932,2812,"reading"
"1729",12,2,154,107,8221182,8224949,3767,"reading"
"1749",12,3,119,108,8232890,8236583,3693,"reading"
"1758",12,2,160,109,8238896,8242350,3454,"reading"
"1778",12,2,180,110,8247532,8251117,3585,"reading"
"1785",12,3,92,111,8254552,8258817,4265,"reading"
"1809",12,3,117,112,8264367,8266984,2617,"reading"
"18111",12,3,107,113,8268870,8271567,2697,"reading"
"1828",12,2,171,114,8274252,8278118,3866,"reading"
"1838",12,2,156,115,8281037,8286535,5498,"reading"
"1858",12,3,103,116,8294139,8298219,4080,"reading"
"1866",12,3,102,117,8301110,8305969,4859,"reading"
"1885",12,3,108,118,8311765,8315586,3821,"reading"
"1899",12,3,109,119,8318396,8321686,3290,"reading"
"1905",12,2,169,120,8324009,8328020,4011,"reading"
"19111",12,3,91,121,8330842,8334020,3178,"reading"
"1939",12,2,161,122,8339435,8342737,3302,"reading"
"1957",12,3,120,123,8349175,8352820,3645,"reading"
"1967",12,3,94,124,8355296,8358070,2774,"reading"
"1988",12,2,162,125,8362623,8365387,2764,"reading"
"2009",12,2,165,126,8370333,8374738,4405,"reading"
"20112",12,3,96,127,8376458,8378571,2113,"reading"
"2038",12,3,93,128,8383960,8388838,4878,"reading"
"2059",12,3,99,129,8394893,8399238,4345,"reading"
"2079",12,3,118,130,8405879,8408839,2960,"reading"
"2087",12,3,115,131,8410838,8412839,2001,"reading"
"2098",12,3,100,132,8566747,8570311,3564,"reading"
"21112",12,3,114,133,8575107,8580811,5704,"reading"
"2129",12,2,167,134,8582877,8586128,3251,"reading"
"2136",12,2,157,135,8587942,8591862,3920,"reading"
"2158",12,2,170,136,8596323,8600229,3906,"reading"
"2166",12,2,172,137,8602099,8604412,2313,"reading"
"21710",12,2,163,138,8607022,8609545,2523,"reading"
"2188",12,3,97,139,8612062,8613946,1884,"reading"
"2207",12,2,159,140,8619500,8622346,2846,"reading"
"2227",12,2,177,141,8628240,8631364,3124,"reading"
"22310",12,2,164,142,8632978,8635513,2535,"reading"
"2248",12,3,116,143,8637447,8639864,2417,"reading"
"2259",12,2,179,144,8642048,8644181,2133,"reading"
"2266",12,3,105,145,8645666,8647980,2314,"reading"
"2278",12,2,166,146,8650394,8653715,3321,"reading"
"2288",12,3,106,147,8655820,8659213,3393,"reading"
"2299",12,2,178,148,8661992,8665464,3472,"reading"
"2307",12,3,104,149,8666994,8669281,2287,"reading"
"23113",12,2,158,150,8672192,8675431,3239,"reading"
"2339",12,1,139,151,8680464,8682798,2334,"reading"
"2349",12,1,149,152,8684555,8687948,3393,"reading"
"2356",12,1,125,153,8690474,8693482,3008,"reading"
"2377",12,1,143,154,8698148,8701565,3417,"reading"
"2386",12,1,150,155,8703648,8706515,2867,"reading"
"2397",12,1,144,156,8709115,8712316,3201,"reading"
"2406",12,1,140,157,8714151,8717399,3248,"reading"
"24113",12,1,146,158,8719565,8722149,2584,"reading"
"2428",12,1,135,159,8723845,8726316,2471,"reading"
"2439",12,1,136,160,8727792,8730166,2374,"reading"
"24411",12,1,142,161,8731620,8734867,3247,"reading"
"2459",12,1,124,162,8736397,8739899,3502,"reading"
"2477",12,1,126,163,8744740,8747750,3010,"reading"
"2497",12,1,128,164,8752586,8755851,3265,"reading"
"25112",12,1,138,165,8761680,8765551,3871,"reading"
"25210",12,1,145,166,8767434,8769601,2167,"reading"
"2538",12,1,132,167,8772611,8775501,2890,"reading"
"2558",12,1,134,168,8779843,8782468,2625,"reading"
"2568",12,1,130,169,8785132,8788251,3119,"reading"
"2586",12,1,123,170,8793468,8795968,2500,"reading"
"2609",12,1,148,171,8801798,8805335,3537,"reading"
"26111",12,1,121,172,8807120,8809935,2815,"reading"
"2637",12,1,147,173,8815627,8818753,3126,"reading"
"2648",12,1,137,174,8820818,8823069,2251,"reading"
"2658",12,1,131,175,8825324,8827720,2396,"reading"
"2677",12,1,141,176,8832623,8835220,2597,"reading"
"2689",12,1,122,177,8836955,8839270,2315,"reading"
"2708",12,1,133,178,8844051,8846437,2386,"reading"
"2712",12,1,129,179,8849307,8851820,2513,"reading"
"2731",12,1,127,180,8856315,8858471,2156,"reading"
"1038",13,1,7,1,11005411,11009428,4017,"reading"
"1230",13,1,15,2,11015694,11019895,4201,"reading"
"1310",13,1,17,3,11021264,11026712,5448,"reading"
"1415",13,1,19,4,11028136,11030729,2593,"reading"
"1520",13,1,30,5,11032310,11035212,2902,"reading"
"1630",13,1,5,6,11036673,11038829,2156,"reading"
"1829",13,1,16,7,11043508,11047663,4155,"reading"
"1927",13,1,12,8,11049229,11054663,5434,"reading"
"2130",13,1,20,9,11061280,11064679,3399,"reading"
"2228",13,1,22,10,11065976,11069163,3187,"reading"
"2340",13,1,6,11,11070527,11073013,2486,"reading"
"2539",13,1,4,12,11077703,11080364,2661,"reading"
"2713",13,1,1,13,11085777,11089864,4087,"reading"
"2910",13,1,3,14,11095712,11099131,3419,"reading"
"318",13,1,25,15,11103740,11107065,3325,"reading"
"3210",13,1,24,16,11108712,11112732,4020,"reading"
"338",13,1,14,17,11114170,11117081,2911,"reading"
"347",13,1,9,18,11118304,11121682,3378,"reading"
"366",13,1,13,19,11125894,11130849,4955,"reading"
"3711",13,1,29,20,11132311,11137649,5338,"reading"
"389",13,1,8,21,11139049,11143866,4817,"reading"
"408",13,1,23,22,11149395,11152833,3438,"reading"
"4110",13,1,10,23,11154315,11158950,4635,"reading"
"4311",13,1,28,24,11163485,11167300,3815,"reading"
"448",13,1,27,25,11168627,11171767,3140,"reading"
"459",13,1,2,26,11173293,11176417,3124,"reading"
"478",13,1,26,27,11181731,11184817,3086,"reading"
"489",13,1,18,28,11186772,11189734,2962,"reading"
"4910",13,1,21,29,11191068,11194451,3383,"reading"
"507",13,1,11,30,11196481,11200718,4237,"reading"
"5210",13,2,31,31,11207204,11213785,6581,"reading"
"548",13,2,32,32,11218453,11221552,3099,"reading"
"5610",13,2,33,33,11227821,11232452,4631,"reading"
"588",13,3,75,34,11238061,11243186,5125,"reading"
"5910",13,2,51,35,11244944,11248702,3758,"reading"
"6010",13,2,47,36,11251057,11254520,3463,"reading"
"6111",13,3,80,37,11257021,11260953,3932,"reading"
"625",13,2,46,38,11262428,11266587,4159,"reading"
"6312",13,3,83,39,11268114,11271937,3823,"reading"
"647",13,2,41,40,11273309,11276087,2778,"reading"
"666",13,2,34,41,11281386,11284421,3035,"reading"
"688",13,3,86,42,11436549,11441042,4493,"reading"
"699",13,3,89,43,11443215,11447076,3861,"reading"
"7010",13,2,56,44,11448534,11450910,2376,"reading"
"719",13,2,40,45,11452921,11456543,3622,"reading"
"738",13,2,50,46,11461379,11464843,3464,"reading"
"7411",13,2,43,47,11466253,11468960,2707,"reading"
"756",13,2,39,48,11470542,11475610,5068,"reading"
"777",13,2,38,49,11479807,11483994,4187,"reading"
"7910",13,3,79,50,11489130,11492061,2931,"reading"
"808",13,3,68,51,11493782,11497327,3545,"reading"
"826",13,3,90,52,11501772,11504295,2523,"reading"
"8310",13,3,73,53,11505666,11508028,2362,"reading"
"848",13,3,87,54,11509265,11513078,3813,"reading"
"858",13,3,64,55,11514649,11519095,4446,"reading"
"879",13,2,49,56,11525241,11528662,3421,"reading"
"888",13,2,36,57,11530710,11534246,3536,"reading"
"9010",13,2,48,58,11538282,11541846,3564,"reading"
"9110",13,3,88,59,11543783,11548796,5013,"reading"
"929",13,3,62,60,11550049,11554180,4131,"reading"
"947",13,3,85,61,11559604,11564713,5109,"reading"
"9511",13,3,77,62,11566433,11570930,4497,"reading"
"969",13,2,45,63,11572402,11576331,3929,"reading"
"9710",13,3,65,64,11577683,11582297,4614,"reading"
"999",13,2,35,65,11589101,11592564,3463,"reading"
"10113",13,2,44,66,11600432,11605298,4866,"reading"
"10213",13,2,52,67,11606656,11610415,3759,"reading"
"1039",13,2,60,68,11611601,11615448,3847,"reading"
"1049",13,2,59,69,11617078,11619632,2554,"reading"
"1057",13,2,54,70,11620861,11624832,3971,"reading"
"1069",13,3,78,71,11626069,11630382,4313,"reading"
"1079",13,3,76,72,11631840,11635199,3359,"reading"
"1089",13,3,69,73,11636683,11640233,3550,"reading"
"1109",13,3,63,74,11645669,11648050,2381,"reading"
"1129",13,3,74,75,11653461,11657733,4272,"reading"
"1139",13,3,70,76,11659254,11663084,3830,"reading"
"1158",13,2,53,77,11668415,11673001,4586,"reading"
"11610",13,2,42,78,11674660,11678517,3857,"reading"
"1188",13,2,37,79,11684027,11688101,4074,"reading"
"12010",13,3,81,80,11692711,11697135,4424,"reading"
"12112",13,3,72,81,11698963,11702935,3972,"reading"
"1236",13,3,67,82,11707389,11710252,2863,"reading"
"1259",13,2,58,83,11715826,11718969,3143,"reading"
"1268",13,2,57,84,11720742,11725369,4627,"reading"
"1279",13,3,71,85,11727154,11729736,2582,"reading"
"1297",13,2,55,86,11734796,11738352,3556,"reading"
"13010",13,3,82,87,11740085,11742969,2884,"reading"
"1317",13,3,84,88,11744538,11748853,4315,"reading"
"1328",13,3,66,89,11750257,11754920,4663,"reading"
"1347",13,3,61,90,11760128,11763387,3259,"reading"
"14510",13,1,111,91,11986380,11990531,4151,"zString"
"1463",13,1,97,92,11992405,11994498,2093,"zString"
"1482",13,1,109,93,11998684,12001515,2831,"zString"
"14912",13,1,105,94,12003163,12006065,2902,"zString"
"1503",13,1,98,95,12007317,12011165,3848,"zString"
"1528",13,1,110,96,12014678,12018582,3904,"zString"
"1537",13,1,116,97,12020134,12024265,4131,"zString"
"1546",13,1,117,98,12026004,12029182,3178,"zString"
"15510",13,1,101,99,12030685,12033599,2914,"zString"
"15710",13,1,113,100,12037269,12039983,2714,"zString"
"1585",13,1,119,101,12041530,12045616,4086,"zString"
"1599",13,1,96,102,12046835,12050399,3564,"zString"
"16115",13,1,112,103,12054037,12056816,2779,"zString"
"16211",13,1,94,104,12058314,12061383,3069,"zString"
"16410",13,1,108,105,12064573,12068400,3827,"zString"
"1658",13,1,120,106,12070769,12075600,4831,"zString"
"1669",13,1,99,107,12077438,12082217,4779,"zString"
"16810",13,1,115,108,12085626,12089468,3842,"zString"
"1697",13,1,92,109,12091509,12096184,4675,"zString"
"17112",13,1,107,110,12101167,12104735,3568,"zString"
"17210",13,1,95,111,12106735,12110652,3917,"zString"
"17410",13,1,93,112,12114542,12117035,2493,"zString"
"1769",13,1,104,113,12121271,12125952,4681,"zString"
"1779",13,1,118,114,12127681,12131169,3488,"zString"
"1786",13,1,103,115,12132840,12137869,5029,"zString"
"1799",13,1,114,116,12139225,12142336,3111,"zString"
"18010",13,1,100,117,12148003,12152603,4600,"zString"
"18210",13,1,102,118,12156704,12160920,4216,"zString"
"1848",13,1,106,119,12164439,12167820,3381,"zString"
"1859",13,1,91,120,12169264,12172771,3507,"zString"
"18711",13,2,121,121,12176713,12179521,2808,"zString"
"18910",13,2,122,122,12183943,12187921,3978,"zString"
"19112",13,2,123,123,12191850,12195454,3604,"zString"
"19310",13,3,176,124,12198824,12202521,3697,"zString"
"1948",13,3,173,125,12204252,12207588,3336,"zString"
"1958",13,3,169,126,12209684,12213222,3538,"zString"
"1968",13,2,136,127,12214829,12219405,4576,"zString"
"1979",13,3,178,128,12220725,12224905,4180,"zString"
"1989",13,2,130,129,12226225,12229889,3664,"zString"
"20010",13,3,175,130,12233594,12237039,3445,"zString"
"20113",13,3,157,131,12238561,12242439,3878,"zString"
"2039",13,2,132,132,12396240,12399928,3688,"zString"
"20510",13,3,166,133,12403798,12407161,3363,"zString"
"20710",13,2,134,135,12432129,12435596,3467,"zString"
"2088",13,3,171,136,12437500,12440012,2512,"zString"
"2099",13,2,138,137,12441349,12444296,2947,"zString"
"21010",13,2,128,138,12445699,12449263,3564,"zString"
"21210",13,2,125,139,12452687,12455563,2876,"zString"
"2149",13,2,145,140,12459299,12461913,2614,"zString"
"2159",13,3,163,141,12463383,12467147,3764,"zString"
"2167",13,3,159,142,12468923,12472598,3675,"zString"
"2189",13,3,155,143,12476133,12480214,4081,"zString"
"2208",13,3,165,144,12483555,12486798,3243,"zString"
"22114",13,3,168,145,12488114,12492164,4050,"zString"
"2229",13,3,162,146,12493517,12496831,3314,"zString"
"2249",13,3,151,147,12500494,12503381,2887,"zString"
"2267",13,2,131,148,12506883,12510431,3548,"zString"
"2289",13,3,153,149,12514548,12518315,3767,"zString"
"2308",13,3,161,150,12522392,12525482,3090,"zString"
"23210",13,3,152,151,12528818,12533349,4531,"zString"
"23410",13,2,142,152,12537373,12540149,2776,"zString"
"2357",13,3,174,153,12541519,12544616,3097,"zString"
"2369",13,2,140,154,12546199,12549583,3384,"zString"
"2378",13,2,141,155,12550869,12553883,3014,"zString"
"2387",13,2,124,156,12555286,12559450,4164,"zString"
"2407",13,2,127,157,12563339,12567017,3678,"zString"
"2429",13,2,126,158,12570803,12574367,3564,"zString"
"24412",13,3,158,159,12578411,12582835,4424,"zString"
"2469",13,2,143,160,12586772,12591486,4714,"zString"
"2478",13,3,172,161,12592988,12598002,5014,"zString"
"2487",13,2,137,162,12599554,12602485,2931,"zString"
"2498",13,2,139,163,12603871,12608285,4414,"zString"
"2508",13,3,179,164,12609810,12613802,3992,"zString"
"25113",13,3,156,165,12615512,12619735,4223,"zString"
"25310",13,3,170,166,12623926,12628469,4543,"zString"
"2548",13,3,164,167,12631299,12635886,4587,"zString"
"2559",13,2,129,168,12637301,12641203,3902,"zString"
"2578",13,2,135,169,12645042,12649620,4578,"zString"
"2587",13,3,180,170,12651442,12655887,4445,"zString"
"25910",13,3,177,171,12657491,12661837,4346,"zString"
"26010",13,3,154,172,12663542,12667120,3578,"zString"
"2629",13,2,146,173,12671185,12677237,6052,"zString"
"2638",13,3,160,174,12679096,12682538,3442,"zString"
"2659",13,2,149,175,12686324,12689371,3047,"zString"
"2667",13,2,144,176,12691163,12695305,4142,"zString"
"2678",13,2,133,177,12697382,12701706,4324,"zString"
"26810",13,3,167,178,12703470,12706471,3001,"zString"
"2699",13,2,148,179,12707938,12711972,4034,"zString"
"2709",13,2,147,180,12714913,12718839,3926,"zString"
"2714",13,2,150,181,12721747,12726406,4659,"zString"
"1040",14,1,67,1,594714,601667,6953,"zString"
"1237",14,1,71,2,608004,617100,9096,"zString"
"1416",14,1,87,3,622300,632284,9984,"zString"
"1529",14,1,72,4,634762,643485,8723,"zString"
"1720",14,1,65,5,647746,655269,7523,"zString"
"1928",14,1,64,6,659855,668652,8797,"zString"
"2137",14,1,79,7,673439,681403,7964,"zString"
"2230",14,1,73,8,683609,689870,6261,"zString"
"2350",14,1,82,9,692332,699587,7255,"zString"
"2430",14,1,69,10,702015,709370,7355,"zString"
"2620",14,1,66,11,713397,721071,7674,"zString"
"286",14,1,90,12,726221,733788,7567,"zString"
"2911",14,1,86,13,736075,744422,8347,"zString"
"3011",14,1,80,14,746582,756355,9773,"zString"
"319",14,1,81,15,758583,764256,5673,"zString"
"3211",14,1,85,16,766489,771689,5200,"zString"
"339",14,1,70,17,773411,778239,4828,"zString"
"358",14,1,89,18,782695,787540,4845,"zString"
"367",14,1,78,19,791521,798492,6971,"zString"
"3712",14,1,74,20,815174,819574,4400,"zString"
"3810",14,1,83,21,821607,826524,4917,"zString"
"3910",14,1,75,22,828291,833525,5234,"zString"
"409",14,1,76,23,835563,840891,5328,"zString"
"4111",14,1,68,24,842819,849559,6740,"zString"
"4312",14,1,63,25,853329,858744,5415,"zString"
"4510",14,1,61,26,863061,868143,5082,"zString"
"479",14,1,88,27,872232,877826,5594,"zString"
"4810",14,1,84,28,879990,886076,6086,"zString"
"4911",14,1,77,29,888030,892677,4647,"zString"
"508",14,1,62,30,894413,898593,4180,"zString"
"5211",14,2,1,31,902984,909061,6077,"zString"
"549",14,2,2,32,913130,918094,4964,"zString"
"5611",14,2,3,33,921923,926328,4405,"zString"
"589",14,2,17,34,930322,934411,4089,"zString"
"5911",14,3,40,35,936385,943795,7410,"zString"
"6112",14,2,6,36,947733,953112,5379,"zString"
"6313",14,2,11,37,956819,963846,7027,"zString"
"6510",14,3,58,38,967967,973113,5146,"zString"
"667",14,3,43,39,975212,982046,6834,"zString"
"679",14,3,44,40,983863,987713,3850,"zString"
"689",14,3,41,41,989738,994564,4826,"zString"
"7011",14,3,54,42,1178129,1183970,5841,"zString"
"7110",14,2,14,43,1188075,1190787,2712,"zString"
"728",14,3,51,44,1193095,1197770,4675,"zString"
"739",14,3,52,45,1199719,1204671,4952,"zString"
"7412",14,2,13,46,1206616,1210604,3988,"zString"
"757",14,2,21,47,1212809,1217355,4546,"zString"
"7611",14,2,28,48,1219217,1224788,5571,"zString"
"778",14,3,37,49,1226274,1230855,4581,"zString"
"7911",14,3,31,50,1235773,1240755,4982,"zString"
"819",14,2,27,51,1244351,1252006,7655,"zString"
"827",14,3,47,52,1254082,1258291,4209,"zString"
"8311",14,3,56,53,1260208,1265072,4864,"zString"
"849",14,3,48,54,1267209,1271923,4714,"zString"
"859",14,2,29,55,1274071,1279390,5319,"zString"
"867",14,3,39,56,1281430,1285540,4110,"zString"
"889",14,2,8,57,1293478,1298524,5046,"zString"
"9011",14,2,7,58,1303372,1308791,5419,"zString"
"9210",14,3,55,59,1313307,1317658,4351,"zString"
"939",14,3,46,60,1320271,1325175,4904,"zString"
"948",14,2,24,61,1326912,1331992,5080,"zString"
"9512",14,3,35,62,1333998,1338142,4144,"zString"
"9711",14,2,16,63,1342066,1346425,4359,"zString"
"989",14,2,22,64,1347985,1353542,5557,"zString"
"9910",14,2,19,65,1355257,1358194,2937,"zString"
"10010",14,2,25,66,1360173,1363426,3253,"zString"
"10114",14,3,53,67,1365619,1370826,5207,"zString"
"10214",14,3,36,68,1372749,1376793,4044,"zString"
"10410",14,2,10,69,1381089,1385076,3987,"zString"
"10610",14,3,42,70,1389792,1393994,4202,"zString"
"10810",14,3,33,71,1397763,1403394,5631,"zString"
"11010",14,2,15,72,1408081,1412877,4796,"zString"
"11110",14,3,45,73,1415042,1420478,5436,"zString"
"11210",14,2,20,74,1422226,1426246,4020,"zString"
"11310",14,3,32,75,1428384,1433212,4828,"zString"
"1159",14,2,26,76,1437202,1441578,4376,"zString"
"11611",14,2,18,77,1443879,1447395,3516,"zString"
"1178",14,3,38,78,1450100,1454162,4062,"zString"
"1199",14,3,59,79,1458600,1462529,3929,"zString"
"12011",14,2,4,80,1465611,1468779,3168,"zString"
"12211",14,2,9,81,1474001,1478380,4379,"zString"
"1249",14,3,57,82,1483222,1487980,4758,"zString"
"12510",14,2,23,83,1490011,1494530,4519,"zString"
"1269",14,3,49,84,1496590,1499580,2990,"zString"
"12710",14,2,30,85,1502044,1506781,4737,"zString"
"1288",14,3,34,86,1508866,1511981,3115,"zString"
"13011",14,3,50,87,1516971,1521032,4061,"zString"
"1318",14,3,60,88,1523897,1527148,3251,"zString"
"1329",14,2,12,89,1529242,1531882,2640,"zString"
"1348",14,2,5,90,1535754,1539598,3844,"zString"
"14511",14,1,160,91,1771758,1775341,3583,"reading"
"14710",14,1,174,92,1781044,1785158,4114,"reading"
"1483",14,1,168,93,1787178,1791425,4247,"reading"
"14913",14,1,177,94,1793710,1799009,5299,"reading"
"1504",14,1,167,95,1801288,1804525,3237,"reading"
"15112",14,1,163,96,1806363,1811326,4963,"reading"
"15210",14,1,178,97,1813114,1817809,4695,"reading"
"1538",14,1,176,98,1819727,1824593,4866,"reading"
"1547",14,1,159,99,1826350,1829943,3593,"reading"
"15610",14,1,152,100,1835201,1840977,5776,"reading"
"1586",14,1,175,101,1845386,1848544,3158,"reading"
"15910",14,1,161,102,1850998,1855029,4031,"reading"
"16116",14,1,172,103,1869401,1872778,3377,"reading"
"16212",14,1,157,104,1874404,1878444,4040,"reading"
"16411",14,1,156,105,1882658,1886512,3854,"reading"
"16610",14,1,166,106,1891743,1897145,5402,"reading"
"1679",14,1,162,107,1898819,1902562,3743,"reading"
"1698",14,1,171,108,1907226,1910129,2903,"reading"
"1709",14,1,165,109,1911814,1918663,6849,"reading"
"17113",14,1,179,110,1920382,1923963,3581,"reading"
"17211",14,1,180,111,1925673,1929013,3340,"reading"
"1738",14,1,155,112,1931014,1936163,5149,"reading"
"1759",14,1,158,113,1941149,1945464,4315,"reading"
"17710",14,1,154,114,1950585,1954197,3612,"reading"
"17910",14,1,170,115,1960380,1964814,4434,"reading"
"18011",14,1,151,116,1966673,1970681,4008,"reading"
"18211",14,1,164,117,1976025,1979465,3440,"reading"
"1839",14,1,173,118,1981102,1984698,3596,"reading"
"1849",14,1,153,119,1986611,1989732,3121,"reading"
"1867",14,1,169,120,1995047,1998699,3652,"reading"
"18712",14,2,91,121,2000502,2004116,3614,"reading"
"18911",14,2,92,122,2008920,2012532,3612,"reading"
"19113",14,2,93,123,2017523,2020783,3260,"reading"
"19311",14,3,135,124,2025559,2028566,3007,"reading"
"1949",14,3,148,125,2030293,2033683,3390,"reading"
"1959",14,2,115,126,2035422,2038000,2578,"reading"
"1969",14,2,109,127,2039903,2043400,3497,"reading"
"19710",14,3,126,128,2045003,2048433,3430,"reading"
"1997",14,2,106,129,2053424,2057351,3927,"reading"
"20011",14,2,108,130,2059004,2061602,2598,"reading"
"20114",14,3,141,131,2063404,2067101,3697,"reading"
"2028",14,3,139,132,2236881,2239957,3076,"reading"
"20310",14,2,99,133,2241990,2245991,4001,"reading"
"20511",14,3,144,134,2251220,2255324,4104,"reading"
"2068",14,2,118,135,2256996,2261058,4062,"reading"
"20711",14,2,119,136,2262477,2266158,3681,"reading"
"2089",14,3,133,137,2267989,2270991,3002,"reading"
"20910",14,3,125,138,2272907,2277177,4270,"reading"
"21113",14,2,105,139,2281609,2286092,4483,"reading"
"21211",14,3,122,140,2288445,2292208,3763,"reading"
"21410",14,3,140,141,2297047,2300225,3178,"reading"
"21510",14,2,100,142,2302005,2306409,4404,"reading"
"21711",14,3,143,143,2310845,2315826,4981,"reading"
"21810",14,3,124,144,2317509,2320893,3384,"reading"
"2209",14,2,111,145,2325505,2329977,4472,"reading"
"22115",14,2,94,146,2331853,2336393,4540,"reading"
"22311",14,3,137,147,2342793,2347160,4367,"reading"
"22410",14,2,114,148,2349694,2354377,4683,"reading"
"22510",14,2,107,149,2356639,2359463,2824,"reading"
"2268",14,3,149,150,2361269,2364411,3142,"reading"
"2279",14,3,129,151,2368582,2372296,3714,"reading"
"22910",14,3,142,152,2376313,2380429,4116,"reading"
"2309",14,3,121,153,2386766,2389812,3046,"reading"
"23211",14,3,127,154,2394198,2397462,3264,"reading"
"23411",14,3,130,155,2403396,2406646,3250,"reading"
"23610",14,2,113,156,2410385,2413762,3377,"reading"
"2379",14,2,110,157,2416796,2419663,2867,"reading"
"2388",14,2,102,158,2421795,2424230,2435,"reading"
"2408",14,2,97,159,2430280,2433146,2866,"reading"
"24210",14,3,138,160,2437242,2441247,4005,"reading"
"24310",14,3,132,161,2443406,2446481,3075,"reading"
"24510",14,3,136,162,2451517,2455264,3747,"reading"
"24610",14,2,116,163,2456909,2460549,3640,"reading"
"2479",14,2,101,164,2462787,2466698,3911,"reading"
"2499",14,3,131,165,2471165,2474298,3133,"reading"
"25114",14,2,112,166,2478734,2481582,2848,"reading"
"25211",14,2,98,167,2483802,2487167,3365,"reading"
"2549",14,2,96,168,2491707,2494315,2608,"reading"
"2569",14,3,146,169,2498351,2501799,3448,"reading"
"2579",14,2,95,170,2503680,2506132,2452,"reading"
"25911",14,3,147,171,2511037,2515266,4229,"reading"
"26011",14,3,134,172,2517252,2521133,3881,"reading"
"26112",14,2,103,173,2523550,2527134,3584,"reading"
"26210",14,3,123,174,2529972,2534950,4978,"reading"
"2649",14,2,117,175,2540808,2543201,2393,"reading"
"26510",14,2,120,176,2546525,2549417,2892,"reading"
"2668",14,3,150,177,2551609,2554534,2925,"reading"
"2679",14,3,145,178,2557015,2559768,2753,"reading"
"26811",14,3,128,179,2561747,2564335,2588,"reading"
"27010",14,2,104,180,2569704,2572653,2949,"reading"
"1050",15,2,61,1,4633923,4637484,3561,"reading"
"1238",15,2,62,2,4642113,4645285,3172,"reading"
"1417",15,2,63,3,4649967,4652835,2868,"reading"
"1638",15,2,67,4,4659607,4662185,2578,"reading"
"1830",15,2,65,5,4667487,4670719,3232,"reading"
"2029",15,2,64,6,4676546,4680003,3457,"reading"
"2240",15,3,15,7,4687556,4691153,3597,"reading"
"2358",15,3,14,8,4693090,4696553,3463,"reading"
"2440",15,2,88,9,4698865,4702653,3788,"reading"
"2540",15,3,6,10,4705251,4708170,2919,"reading"
"2715",15,2,76,11,4712584,4715854,3270,"reading"
"287",15,3,16,12,4718039,4721370,3331,"reading"
"2912",15,2,77,13,4724860,4727537,2677,"reading"
"3012",15,3,19,14,4729868,4733588,3720,"reading"
"3110",15,2,81,15,4736969,4741071,4102,"reading"
"3212",15,3,13,16,4742969,4746238,3269,"reading"
"3310",15,3,7,17,4748184,4751738,3554,"reading"
"359",15,2,71,18,4759454,4762339,2885,"reading"
"3713",15,3,17,19,4767837,4771322,3485,"reading"
"3811",15,3,23,20,4773612,4777039,3427,"reading"
"3911",15,3,21,21,4779931,4783372,3441,"reading"
"4010",15,2,83,22,4786331,4789089,2758,"reading"
"4112",15,2,73,23,4791112,4794123,3011,"reading"
"428",15,3,12,24,4797059,4800090,3031,"reading"
"449",15,3,22,25,4806302,4809190,2888,"reading"
"4511",15,3,25,26,4811188,4814757,3569,"reading"
"468",15,3,18,27,4817202,4821041,3839,"reading"
"4710",15,2,70,28,4823923,4826724,2801,"reading"
"4912",15,3,3,29,4832477,4835741,3264,"reading"
"518",15,2,74,30,4842117,4845875,3758,"reading"
"5212",15,3,30,31,4849516,4852742,3226,"reading"
"535",15,3,9,32,4854708,4857825,3117,"reading"
"554",15,2,82,33,4863750,4867942,4192,"reading"
"5612",15,2,75,34,4871344,4874993,3649,"reading"
"575",15,2,89,35,4877418,4880693,3275,"reading"
"5810",15,2,68,36,4883610,4886560,2950,"reading"
"6011",15,2,84,37,4892420,4894743,2323,"reading"
"6113",15,2,72,38,4897511,4900427,2916,"reading"
"6314",15,3,29,39,4907097,4909810,2713,"reading"
"648",15,2,86,40,4911710,4915494,3784,"reading"
"6511",15,3,2,41,4919111,4922944,3833,"reading"
"6710",15,2,80,42,5066594,5070282,3688,"reading"
"6810",15,2,69,43,5073934,5077516,3582,"reading"
"7012",15,2,66,44,5083556,5086583,3027,"reading"
"729",15,2,90,45,5092886,5095617,2731,"reading"
"7310",15,3,4,46,5099020,5102700,3680,"reading"
"758",15,2,78,47,5109514,5112317,2803,"reading"
"7612",15,3,11,48,5116318,5119951,3633,"reading"
"787",15,3,28,49,5126286,5128817,2531,"reading"
"7912",15,2,87,50,5131408,5133884,2476,"reading"
"809",15,3,5,51,5136795,5139518,2723,"reading"
"828",15,3,8,52,5144739,5149119,4380,"reading"
"8410",15,2,85,53,5159984,5163685,3701,"reading"
"8510",15,3,10,54,5167274,5169802,2528,"reading"
"8710",15,2,79,55,5176775,5180052,3277,"reading"
"8810",15,3,24,56,5182209,5185086,2877,"reading"
"8910",15,3,20,57,5187295,5189803,2508,"reading"
"9012",15,3,27,58,5193496,5196070,2574,"reading"
"9111",15,3,26,59,5198295,5200670,2375,"reading"
"9211",15,3,1,60,5202615,5205220,2605,"reading"
"949",15,1,43,61,5211731,5216037,4306,"reading"
"9513",15,1,60,62,5219628,5223004,3376,"reading"
"9610",15,1,35,63,5226537,5229205,2668,"reading"
"9810",15,1,55,64,5238611,5241071,2460,"reading"
"9911",15,1,56,65,5246071,5248805,2734,"reading"
"10011",15,1,45,66,5253384,5256639,3255,"reading"
"10115",15,1,53,67,5260282,5264039,3757,"reading"
"10215",15,1,58,68,5269201,5272839,3638,"reading"
"10310",15,1,36,69,5274948,5277689,2741,"reading"
"1058",15,1,48,70,5286244,5290923,4679,"reading"
"10611",15,1,40,71,5293254,5296073,2819,"reading"
"10811",15,1,33,72,5302063,5305224,3161,"reading"
"11011",15,1,54,73,5311115,5313441,2326,"reading"
"11111",15,1,37,74,5316201,5319491,3290,"reading"
"11311",15,1,41,75,5327466,5331208,3742,"reading"
"11510",15,1,52,76,5336786,5340608,3822,"reading"
"11612",15,1,44,77,5344365,5346475,2110,"reading"
"1179",15,1,31,78,5349838,5354509,4671,"reading"
"11910",15,1,57,79,5361129,5364126,2997,"reading"
"12012",15,1,50,80,5366083,5370326,4243,"reading"
"12113",15,1,38,81,5372325,5376543,4218,"reading"
"1239",15,1,32,82,5383847,5386660,2813,"reading"
"12511",15,1,51,83,5394967,5399144,4177,"reading"
"12610",15,1,46,84,5402670,5407344,4674,"reading"
"12711",15,1,39,85,5409522,5413594,4072,"reading"
"1298",15,1,49,86,5421304,5426028,4724,"reading"
"13012",15,1,34,87,5427868,5431145,3277,"reading"
"13210",15,1,47,88,5437834,5444045,6211,"reading"
"13310",15,1,42,89,5445996,5450545,4549,"reading"
"13511",15,1,59,90,5458537,5461029,2492,"reading"
"14512",15,2,151,91,5560481,5568483,8002,"zString"
"14711",15,2,152,92,5574365,5583734,9369,"zString"
"14914",15,2,153,93,5589019,5599784,10765,"zString"
"15113",15,3,97,94,5604400,5612867,8467,"zString"
"1539",15,2,172,95,5617438,5627318,9880,"zString"
"1548",15,3,103,96,5630262,5640702,10440,"zString"
"15511",15,3,101,97,5642730,5653553,10823,"zString"
"15711",15,2,157,98,5659217,5672669,13452,"zString"
"15911",15,3,98,99,5676663,5685520,8857,"zString"
"16117",15,2,163,100,5689663,5699354,9691,"zString"
"16213",15,3,107,101,5701255,5706137,4882,"zString"
"1639",15,3,116,102,5708402,5712871,4469,"zString"
"16412",15,2,160,103,5714433,5723505,9072,"zString"
"16611",15,3,113,104,5727846,5735655,7809,"zString"
"16710",15,2,178,105,5739142,5746789,7647,"zString"
"16811",15,2,161,106,5748764,5757589,8825,"zString"
"17010",15,2,156,107,5761800,5769256,7456,"zString"
"17212",15,2,167,108,5773440,5781690,8250,"zString"
"1739",15,3,108,109,5783740,5789090,5350,"zString"
"17411",15,2,174,110,5790976,5797307,6331,"zString"
"17510",15,2,170,111,5799395,5808558,9163,"zString"
"17610",15,3,119,112,5811042,5821924,10882,"zString"
"17711",15,3,112,113,5825063,5836391,11328,"zString"
"1787",15,3,120,114,5838089,5849792,11703,"zString"
"17911",15,3,91,115,5851678,5861626,9948,"zString"
"18112",15,3,114,116,5866122,5878176,12054,"zString"
"18212",15,3,99,117,5880235,5893694,13459,"zString"
"18410",15,3,105,118,5898132,5908778,10646,"zString"
"18510",15,2,173,119,5911006,5921011,10005,"zString"
"1868",15,2,154,120,5923524,5938512,14988,"zString"
"1886",15,3,100,121,5942485,5956929,14444,"zString"
"1906",15,2,175,122,5963286,5973946,10660,"zString"
"19114",15,2,176,123,5975783,5985913,10130,"zString"
"1929",15,2,158,124,5987693,6001164,13471,"zString"
"19410",15,2,166,125,6007294,6019665,12371,"zString"
"19510",15,3,109,126,6021780,6029932,8152,"zString"
"19610",15,3,106,127,6033347,6040615,7268,"zString"
"19711",15,3,102,128,6043380,6053616,10236,"zString"
"1998",15,3,94,129,6058369,6066283,7914,"zString"
"20115",15,2,168,130,6070767,6076866,6099,"zString"
"20210",15,3,95,131,6078907,6086300,7393,"zString"
"20512",15,3,115,133,6162151,6166205,4054,"zString"
"2069",15,3,96,134,6168289,6171705,3416,"zString"
"20810",15,3,104,135,6178586,6183389,4803,"zString"
"20911",15,2,179,136,6186785,6191389,4604,"zString"
"21011",15,2,171,137,6193796,6200456,6660,"zString"
"21114",15,2,162,138,6204199,6211239,7040,"zString"
"2138",15,3,92,139,6218588,6222623,4035,"zString"
"21511",15,3,117,140,6228333,6232640,4307,"zString"
"2168",15,3,118,141,6236140,6242057,5917,"zString"
"21712",15,2,169,142,6259403,6265108,5705,"zString"
"21811",15,2,165,143,6266669,6272841,6172,"zString"
"21910",15,2,159,144,6275397,6282492,7095,"zString"
"22116",15,2,164,145,6288793,6296208,7415,"zString"
"22210",15,3,111,146,6299874,6306243,6369,"zString"
"22312",15,3,93,147,6314517,6320876,6359,"zString"
"2269",15,2,180,149,6351865,6358078,6213,"zString"
"22810",15,2,155,151,6389106,6394812,5706,"zString"
"23212",15,3,110,154,6454526,6459831,5305,"zString"
"23310",15,2,177,155,6462322,6471248,8926,"zString"
"23412",15,1,128,156,6474140,6479365,5225,"zString"
"23611",15,1,147,157,6485528,6491366,5838,"zString"
"23710",15,1,149,158,6496665,6503249,6584,"zString"
"2389",15,1,134,159,6505966,6510666,4700,"zString"
"2398",15,1,136,160,6513496,6518251,4755,"zString"
"2409",15,1,129,161,6522883,6530517,7634,"zString"
"24211",15,1,148,162,6536188,6542034,5846,"zString"
"24311",15,1,121,163,6545024,6549834,4810,"zString"
"24511",15,1,142,164,6554481,6564268,9787,"zString"
"24611",15,1,122,165,6568490,6575068,6578,"zString"
"2488",15,1,137,166,6581826,6589019,7193,"zString"
"24910",15,1,127,167,6592591,6597986,5395,"zString"
"25115",15,1,130,168,6603915,6608953,5038,"zString"
"25311",15,1,140,169,6617832,6621820,3988,"zString"
"25410",15,1,146,170,6625349,6633037,7688,"zString"
"25510",15,1,131,171,6636858,6641854,4996,"zString"
"25710",15,1,141,172,6649102,6656188,7086,"zString"
"2588",15,1,126,173,6660488,6671105,10617,"zString"
"26012",15,1,133,174,6675730,6684439,8709,"zString"
"26113",15,1,124,175,6688961,6694189,5228,"zString"
"2639",15,1,150,176,6701833,6708689,6856,"zString"
"26410",15,1,132,177,6712960,6715740,2780,"zString"
"2669",15,1,135,178,6721355,6725257,3902,"zString"
"26710",15,1,138,179,6727643,6732557,4914,"zString"
"26812",15,1,145,180,6736515,6742441,5926,"zString"
"26910",15,1,144,181,6746774,6751174,4400,"zString"
"27011",15,1,139,182,6753403,6758758,5355,"zString"
"2716",15,1,125,183,6762395,6770575,8180,"zString"
"2732",15,1,143,184,6778407,6783942,5535,"zString"
"2741",15,1,123,185,6786483,6790959,4476,"zString"
"1059",16,2,31,1,7791916,7799728,7812,"zString"
"1240",16,2,32,2,7804473,7807662,3189,"zString"
"1418",16,2,33,3,7812378,7815562,3184,"zString"
"1640",16,3,87,4,7819391,7822412,3021,"zString"
"1730",16,3,66,5,7824169,7827380,3211,"zString"
"1930",16,3,89,6,7831632,7834696,3064,"zString"
"2030",16,2,45,7,7837404,7840597,3193,"zString"
"2139",16,2,57,8,7842759,7845763,3004,"zString"
"2250",16,2,53,9,7848239,7850980,2741,"zString"
"2359",16,3,64,10,7852562,7856514,3952,"zString"
"2550",16,3,86,11,7860585,7863631,3046,"zString"
"2630",16,3,82,12,7866388,7868948,2560,"zString"
"2717",16,3,80,13,7870528,7874131,3603,"zString"
"288",16,3,70,14,7875990,7878914,2924,"zString"
"3013",16,2,58,15,7883942,7886798,2856,"zString"
"3111",16,3,79,16,7888532,7891732,3200,"zString"
"3213",16,2,39,17,7893212,7896381,3169,"zString"
"348",16,3,81,18,7900545,7902948,2403,"zString"
"3510",16,3,84,19,7905874,7909249,3375,"zString"
"368",16,2,48,20,7910938,7914116,3178,"zString"
"3714",16,3,72,21,7915797,7919766,3969,"zString"
"3912",16,2,60,22,7923546,7926749,3203,"zString"
"4011",16,2,46,23,7928497,7931083,2586,"zString"
"4113",16,3,73,24,7933114,7936850,3736,"zString"
"429",16,2,50,25,7939420,7942050,2630,"zString"
"4313",16,3,74,26,7943949,7946067,2118,"zString"
"4410",16,3,90,27,7947887,7950550,2663,"zString"
"4512",16,2,38,28,7953303,7956200,2897,"zString"
"4711",16,3,62,29,7962468,7965084,2616,"zString"
"4913",16,3,88,30,7969263,7972217,2954,"zString"
"509",16,3,85,31,7974326,7977134,2808,"zString"
"519",16,2,49,32,7979232,7981385,2153,"zString"
"5213",16,3,71,33,7983053,7986218,3165,"zString"
"5410",16,2,47,34,7990134,7993085,2951,"zString"
"555",16,3,67,35,7994968,7997468,2500,"zString"
"576",16,2,35,36,8001981,8004219,2238,"zString"
"5912",16,3,76,37,8008322,8011136,2814,"zString"
"6012",16,3,75,38,8013276,8016286,3010,"zString"
"6114",16,2,37,39,8018329,8020553,2224,"zString"
"6315",16,2,54,40,8025370,8027653,2283,"zString"
"649",16,3,77,41,8029466,8031420,1954,"zString"
"6512",16,2,56,42,8074419,8077523,3104,"zString"
"668",16,3,68,43,8079443,8082623,3180,"zString"
"6811",16,3,65,44,8088331,8090490,2159,"zString"
"7013",16,3,63,45,8094867,8097791,2924,"zString"
"7210",16,2,59,46,8105556,8108241,2685,"zString"
"7311",16,2,36,47,8110080,8112891,2811,"zString"
"759",16,2,51,48,8116943,8120391,3448,"zString"
"7613",16,3,83,49,8122288,8124992,2704,"zString"
"779",16,2,52,50,8126773,8129725,2952,"zString"
"788",16,2,40,51,8131447,8134108,2661,"zString"
"8010",16,2,44,52,8138004,8140425,2421,"zString"
"8110",16,2,55,53,8142063,8144359,2296,"zString"
"829",16,2,34,54,8147410,8150292,2882,"zString"
"8411",16,2,42,55,8154197,8156443,2246,"zString"
"868",16,3,69,56,8159980,8162026,2046,"zString"
"8811",16,2,41,57,8166410,8168726,2316,"zString"
"9013",16,3,78,58,8172645,8175510,2865,"zString"
"9112",16,2,43,59,8177146,8180477,3331,"zString"
"9212",16,3,61,60,8182183,8185160,2977,"zString"
"9410",16,1,24,61,8189101,8191677,2576,"zString"
"9514",16,1,21,62,8193495,8196560,3065,"zString"
"9611",16,1,4,63,8198471,8201278,2807,"zString"
"9811",16,1,11,64,8205188,8208378,3190,"zString"
"10012",16,1,7,65,8212390,8214495,2105,"zString"
"10216",16,1,20,66,8218168,8220728,2560,"zString"
"10311",16,1,25,67,8222197,8224228,2031,"zString"
"10411",16,1,27,68,8225814,8228312,2498,"zString"
"10510",16,1,5,69,8229986,8232078,2092,"zString"
"10710",16,1,16,70,8236251,8239129,2878,"zString"
"10812",16,1,12,71,8240913,8243379,2466,"zString"
"11012",16,1,1,72,8247567,8249829,2262,"zString"
"11211",16,1,14,73,8254324,8256746,2422,"zString"
"11312",16,1,8,74,8258439,8261113,2674,"zString"
"11511",16,1,18,75,8266846,8268780,1934,"zString"
"11613",16,1,28,76,8270660,8273446,2786,"zString"
"11710",16,1,17,77,8275080,8277080,2000,"zString"
"1189",16,1,23,78,8279130,8281314,2184,"zString"
"11911",16,1,15,79,8282945,8285763,2818,"zString"
"12013",16,1,9,80,8287197,8288997,1800,"zString"
"12212",16,1,26,81,8292817,8295397,2580,"zString"
"12310",16,1,2,82,8296967,8298897,1930,"zString"
"12512",16,1,6,83,8302556,8304647,2091,"zString"
"12712",16,1,19,84,8308463,8310982,2519,"zString"
"1289",16,1,10,85,8313051,8315098,2047,"zString"
"13013",16,1,30,86,8318733,8321181,2448,"zString"
"1319",16,1,13,87,8322812,8324732,1920,"zString"
"13211",16,1,29,88,8326411,8328715,2304,"zString"
"13311",16,1,22,89,8330315,8333682,3367,"zString"
"1349",16,1,3,90,8335700,8338365,2665,"zString"
"14513",16,2,121,91,8459469,8463453,3984,"reading"
"14712",16,2,122,92,8468310,8472070,3760,"reading"
"14915",16,2,123,93,8477892,8481754,3862,"reading"
"15114",16,3,164,94,8488598,8493121,4523,"reading"
"15211",16,3,161,95,8494955,8499504,4549,"reading"
"1549",16,2,148,96,8510182,8515088,4906,"reading"
"15512",16,3,156,97,8516824,8521555,4731,"reading"
"15712",16,2,136,98,8528471,8532405,3934,"reading"
"1587",16,3,166,99,8534511,8539089,4578,"reading"
"15912",16,2,146,100,8541176,8544639,3463,"reading"
"1609",16,2,132,101,8546496,8550372,3876,"reading"
"16214",16,2,138,102,8556489,8560540,4051,"reading"
"16310",16,2,145,103,8562509,8565656,3147,"reading"
"16413",16,3,152,104,8567277,8572407,5130,"reading"
"16612",16,3,171,105,8577660,8580857,3197,"reading"
"16711",16,3,173,106,8582500,8587090,4590,"reading"
"16812",16,3,155,107,8588933,8594491,5558,"reading"
"17011",16,3,165,108,8600372,8605925,5553,"reading"
"17114",16,2,140,109,8607875,8612492,4617,"reading"
"17213",16,2,134,110,8614536,8619091,4555,"reading"
"17310",16,3,158,111,8620726,8625409,4683,"reading"
"17511",16,2,144,112,8631563,8636709,5146,"reading"
"17611",16,3,153,113,8638559,8642076,3517,"reading"
"1788",16,2,139,114,8647568,8650593,3025,"reading"
"17912",16,2,141,115,8652527,8658076,5549,"reading"
"18012",16,2,125,116,8659671,8664026,4355,"reading"
"18213",16,3,157,117,8668808,8673960,5152,"reading"
"18411",16,3,151,118,8679236,8683760,4524,"reading"
"1869",16,3,167,119,8689968,8694427,4459,"reading"
"18713",16,3,160,120,8696053,8700611,4558,"reading"
"18912",16,3,169,121,8706660,8710645,3985,"reading"
"1907",16,2,128,122,8712327,8716611,4284,"reading"
"19210",16,2,142,123,8722066,8726112,4046,"reading"
"19312",16,2,143,124,8727960,8732295,4335,"reading"
"19411",16,3,170,125,8734050,8739046,4996,"reading"
"19511",16,2,130,126,8740582,8744962,4380,"reading"
"19712",16,2,127,127,8750813,8754796,3983,"reading"
"1999",16,3,175,128,8759780,8763696,3916,"reading"
"20012",16,3,179,129,8765765,8769446,3681,"reading"
"20116",16,2,133,130,8770984,8774564,3580,"reading"
"20211",16,3,180,131,8776681,8780281,3600,"reading"
"20311",16,2,124,132,8802437,8806799,4362,"reading"
"20513",16,3,154,133,8811892,8815816,3924,"reading"
"20712",16,3,178,134,8820757,8824416,3659,"reading"
"20811",16,2,147,135,8826404,8829783,3379,"reading"
"20912",16,2,126,136,8831662,8835167,3505,"reading"
"21115",16,3,159,137,8841696,8846084,4388,"reading"
"21310",16,2,131,138,8853341,8856835,3494,"reading"
"21512",16,2,137,139,8862235,8865951,3716,"reading"
"2169",16,2,150,140,8869057,8873435,4378,"reading"
"21713",16,2,129,141,8875115,8879336,4221,"reading"
"21911",16,2,135,142,8885178,8888869,3691,"reading"
"22010",16,3,177,143,8892492,8897002,4510,"reading"
"22117",16,3,163,144,8898931,8902936,4005,"reading"
"22211",16,3,162,145,8904602,8908153,3551,"reading"
"22411",16,3,168,146,8913164,8918170,5006,"reading"
"22511",16,3,172,147,8919974,8924020,4046,"reading"
"22610",16,3,176,148,8925656,8929836,4180,"reading"
"22710",16,3,174,149,8931525,8936037,4512,"reading"
"22811",16,2,149,150,8937714,8942654,4940,"reading"
"22911",16,1,113,151,8944862,8948904,4042,"reading"
"23010",16,1,116,152,8950569,8954004,3435,"reading"
"23114",16,1,103,153,8955932,8959838,3906,"reading"
"23213",16,1,110,154,8961307,8964571,3264,"reading"
"23311",16,1,99,155,8966324,8969671,3347,"reading"
"23510",16,1,106,156,8976939,8980972,4033,"reading"
"23612",16,1,119,157,8982821,8987439,4618,"reading"
"23711",16,1,100,158,8989066,8993073,4007,"reading"
"2399",16,1,95,159,8998555,9001923,3368,"reading"
"24114",16,1,107,160,9008031,9012290,4259,"reading"
"24212",16,1,109,161,9015564,9018656,3092,"reading"
"24312",16,1,92,162,9020159,9024323,4164,"reading"
"24512",16,1,94,163,9029560,9033143,3583,"reading"
"24710",16,1,118,164,9038612,9042642,4030,"reading"
"2489",16,1,101,165,9044367,9048024,3657,"reading"
"2509",16,1,115,166,9053465,9057724,4259,"reading"
"25116",16,1,98,167,9059679,9063558,3879,"reading"
"25312",16,1,93,168,9068767,9072510,3743,"reading"
"25511",16,1,112,169,9077615,9080375,2760,"reading"
"25610",16,1,114,170,9082593,9086825,4232,"reading"
"25711",16,1,111,171,9088510,9092459,3949,"reading"
"2589",16,1,97,172,9094047,9097276,3229,"reading"
"26013",16,1,120,173,9101327,9105276,3949,"reading"
"26114",16,1,108,174,9106801,9110793,3992,"reading"
"26211",16,1,96,175,9112460,9115776,3316,"reading"
"26411",16,1,102,176,9120818,9123893,3075,"reading"
"26610",16,1,104,177,9129673,9133727,4054,"reading"
"26711",16,1,117,178,9135543,9139310,3767,"reading"
"26813",16,1,91,179,9141039,9145111,4072,"reading"
"27012",16,1,105,180,9150894,9154911,4017,"reading"
"1060",17,1,67,1,1439711,1446982,7271,"reading"
"1250",17,1,81,2,1453306,1459983,6677,"reading"
"1320",17,1,65,3,1466103,1471500,5397,"reading"
"1530",17,1,85,4,1480263,1492034,11771,"reading"
"1650",17,1,64,5,1495301,1502301,7000,"reading"
"1840",17,1,71,6,1508855,1515018,6163,"reading"
"2140",17,1,80,8,1555392,1562353,6961,"reading"
"2260",17,1,78,9,1564858,1574005,9147,"reading"
"2360",17,1,63,10,1576095,1582687,6592,"reading"
"2560",17,1,73,11,1590926,1595588,4662,"reading"
"2640",17,1,62,12,1597460,1602554,5094,"reading"
"2913",17,1,75,14,1642529,1652006,9477,"reading"
"3014",17,1,86,15,1654201,1661156,6955,"reading"
"3112",17,1,74,16,1663145,1670290,7145,"reading"
"3214",17,1,61,17,1675426,1680223,4797,"reading"
"349",17,1,79,18,1687228,1691991,4763,"reading"
"3511",17,1,84,19,1694871,1703741,8870,"reading"
"369",17,1,89,20,1708404,1713524,5120,"reading"
"3715",17,1,68,21,1716278,1721792,5514,"reading"
"4012",17,1,76,23,1749783,1754459,4676,"reading"
"4114",17,1,72,24,1757898,1763709,5811,"reading"
"4411",17,1,88,26,1798601,1806478,7877,"reading"
"4513",17,1,82,27,1811006,1818278,7272,"reading"
"469",17,1,70,28,1825047,1835495,10448,"reading"
"4811",17,1,90,29,1845689,1856880,11191,"reading"
"4914",17,1,69,30,1860528,1864079,3551,"reading"
"5214",17,1,77,32,1896236,1901515,5279,"reading"
"536",17,1,87,33,1903495,1912481,8986,"reading"
"5411",17,1,66,34,1914875,1919081,4206,"reading"
"5613",17,1,83,35,1923780,1934348,10568,"reading"
"577",17,2,1,36,1936183,1947032,10849,"reading"
"5913",17,2,2,37,1950836,1962233,11397,"reading"
"6115",17,2,3,38,1967209,1970900,3691,"reading"
"6316",17,2,28,39,1979700,1987034,7334,"reading"
"6410",17,2,24,40,1988542,1997034,8492,"reading"
"6513",17,2,13,41,1998473,2008403,9930,"reading"
"669",17,3,37,42,2009952,2018619,8667,"reading"
"6812",17,3,50,43,2023209,2029985,6776,"reading"
"6910",17,3,34,44,2031785,2038253,6468,"reading"
"7111",17,3,32,45,2043250,2047438,4188,"reading"
"7312",17,3,47,46,2053477,2060454,6977,"reading"
"7413",17,3,35,47,2244976,2248961,3985,"reading"
"7614",17,2,23,48,2255740,2260111,4371,"reading"
"7710",17,3,49,49,2262159,2266662,4503,"reading"
"789",17,2,22,50,2268145,2271261,3116,"reading"
"7913",17,2,26,51,2273984,2277895,3911,"reading"
"8011",17,3,41,52,2279488,2282361,2873,"reading"
"8210",17,2,9,53,2287667,2292512,4845,"reading"
"8412",17,2,12,54,2297202,2302996,5794,"reading"
"869",17,3,40,55,2307901,2314130,6229,"reading"
"8812",17,2,29,56,2319287,2324046,4759,"reading"
"8911",17,3,54,57,2325849,2328380,2531,"reading"
"9014",17,3,44,58,2330231,2334697,4466,"reading"
"9113",17,2,19,59,2336169,2339697,3528,"reading"
"9213",17,2,8,60,2341174,2349881,8707,"reading"
"9411",17,2,7,61,2354511,2358614,4103,"reading"
"9612",17,3,31,62,2364253,2371765,7512,"reading"
"9812",17,3,59,63,2377354,2381532,4178,"reading"
"9912",17,2,5,64,2382934,2385865,2931,"reading"
"10116",17,3,42,65,2389965,2394082,4117,"reading"
"10312",17,2,21,66,2398630,2407266,8636,"reading"
"10412",17,3,43,67,2408552,2416433,7881,"reading"
"10511",17,3,46,68,2417736,2421550,3814,"reading"
"10612",17,3,57,69,2423015,2426050,3035,"reading"
"10711",17,3,48,70,2427864,2432383,4519,"reading"
"10813",17,2,27,71,2434242,2442633,8391,"reading"
"1098",17,3,33,72,2444015,2448017,4002,"reading"
"11112",17,2,10,73,2453438,2455951,2513,"reading"
"11313",17,2,18,74,2460541,2466368,5827,"reading"
"1148",17,2,11,75,2468261,2477068,8807,"reading"
"11614",17,3,51,76,2481917,2489769,7852,"reading"
"11711",17,3,39,77,2491169,2501669,10500,"reading"
"11912",17,2,16,78,2506344,2509386,3042,"reading"
"12014",17,3,60,79,2510923,2515686,4763,"reading"
"12114",17,3,55,80,2517175,2525020,7845,"reading"
"12213",17,3,45,81,2526506,2532153,5647,"reading"
"12311",17,3,52,82,2534073,2542087,8014,"reading"
"12410",17,2,17,83,2543640,2549687,6047,"reading"
"12513",17,3,36,84,2551201,2553954,2753,"reading"
"12713",17,2,15,85,2558741,2564071,5330,"reading"
"12810",17,3,38,86,2565514,2568372,2858,"reading"
"13014",17,2,25,87,2573579,2576588,3009,"reading"
"13110",17,2,14,88,2578226,2582055,3829,"reading"
"13212",17,3,53,89,2583442,2587689,4247,"reading"
"13312",17,3,56,90,2589610,2593239,3629,"reading"
"13410",17,2,4,91,2595604,2598955,3351,"reading"
"1362",17,2,6,92,2604083,2606856,2773,"reading"
"1382",17,2,20,93,2611246,2617690,6444,"reading"
"1391",17,3,58,94,2619713,2622373,2660,"reading"
"140",17,2,30,95,2624013,2626940,2927,"reading"
"1505",17,1,167,96,2719303,2725510,6207,"zString"
"15115",17,1,154,97,2727456,2733710,6254,"zString"
"15310",17,1,173,98,2738189,2745394,7205,"zString"
"15410",17,1,171,99,2747772,2752262,4490,"zString"
"15513",17,1,153,100,2754202,2760994,6792,"zString"
"15713",17,1,163,101,2764769,2769445,4676,"zString"
"1588",17,1,176,102,2771302,2776178,4876,"zString"
"15913",17,1,180,103,2777960,2784212,6252,"zString"
"16010",17,1,170,104,2785643,2791545,5902,"zString"
"16118",17,1,164,105,2793255,2797496,4241,"zString"
"16215",17,1,178,106,2799173,2804229,5056,"zString"
"16311",17,1,177,107,2806004,2812730,6726,"zString"
"16414",17,1,160,108,2814562,2821746,7184,"zString"
"16613",17,1,168,109,2825971,2831096,5125,"zString"
"16712",17,1,159,110,2832626,2837681,5055,"zString"
"1699",17,1,169,111,2841608,2848097,6489,"zString"
"17012",17,1,172,112,2850031,2855397,5366,"zString"
"17115",17,1,165,113,2857110,2861681,4571,"zString"
"17214",17,1,151,114,2863219,2868531,5312,"zString"
"17412",17,1,158,115,2873060,2878315,5255,"zString"
"17612",17,1,161,116,2882053,2886965,4912,"zString"
"1789",17,1,166,117,2891274,2897216,5942,"zString"
"17913",17,1,175,118,2898773,2904916,6143,"zString"
"18013",17,1,179,119,2906506,2912449,5943,"zString"
"18113",17,1,157,120,2914272,2921349,7077,"zString"
"18310",17,1,152,121,2925938,2932067,6129,"zString"
"18511",17,1,156,122,2936839,2943450,6611,"zString"
"18714",17,1,155,123,2947615,2953067,5452,"zString"
"18913",17,1,174,124,2957272,2963301,6029,"zString"
"1908",17,1,162,125,2964980,2972951,7971,"zString"
"19211",17,2,91,126,2976779,2982168,5389,"zString"
"19412",17,2,92,127,2986082,2991036,4954,"zString"
"19611",17,2,93,128,2994904,3000202,5298,"zString"
"19810",17,2,98,129,3003970,3007853,3883,"zString"
"20013",17,3,148,130,3011850,3017619,5769,"zString"
"20117",17,3,122,131,3019579,3024720,5141,"zString"
"20312",17,2,110,132,3029240,3032603,3363,"zString"
"20410",17,3,146,133,3034151,3038954,4803,"zString"
"20514",17,3,149,134,3040820,3050170,9350,"zString"
"20610",17,2,111,135,3051828,3055638,3810,"zString"
"20713",17,3,133,136,3057191,3061821,4630,"zString"
"20812",17,3,134,137,3084991,3091207,6216,"zString"
"20913",17,2,100,138,3093347,3097507,4160,"zString"
"21116",17,3,138,139,3101395,3106192,4797,"zString"
"21212",17,2,101,140,3107792,3115741,7949,"zString"
"21411",17,3,129,141,3119567,3126459,6892,"zString"
"21610",17,3,130,142,3130415,3135942,5527,"zString"
"21812",17,3,139,143,3140167,3148509,8342,"zString"
"21912",17,3,128,144,3150591,3156193,5602,"zString"
"22118",17,3,145,145,3159789,3165343,5554,"zString"
"22212",17,3,123,146,3166854,3171160,4306,"zString"
"22412",17,3,141,147,3175065,3186077,11012,"zString"
"22512",17,2,109,148,3187597,3191261,3664,"zString"
"22611",17,2,97,149,3192969,3196878,3909,"zString"
"22812",17,3,127,150,3200768,3205094,4326,"zString"
"23011",17,2,118,151,3209092,3214245,5153,"zString"
"23115",17,3,135,152,3216442,3222978,6536,"zString"
"23214",17,2,112,153,3224450,3230162,5712,"zString"
"23312",17,2,105,154,3231826,3237497,5671,"zString"
"23413",17,3,124,155,3239338,3245612,6274,"zString"
"23613",17,3,125,156,3249119,3254429,5310,"zString"
"23810",17,3,140,157,3257959,3264346,6387,"zString"
"23910",17,3,132,158,3266484,3272930,6446,"zString"
"24115",17,2,107,159,3277024,3283497,6473,"zString"
"24213",17,3,131,160,3285445,3290681,5236,"zString"
"24413",17,2,117,161,3294838,3299814,4976,"zString"
"24513",17,3,136,162,3301394,3306315,4921,"zString"
"24612",17,2,103,163,3308143,3313198,5055,"zString"
"24711",17,2,95,164,3315154,3319582,4428,"zString"
"24911",17,2,99,165,3323089,3328415,5326,"zString"
"25117",17,2,115,166,3332399,3336549,4150,"zString"
"25212",17,3,121,167,3338300,3342366,4066,"zString"
"25411",17,3,150,168,3347323,3353499,6176,"zString"
"25512",17,2,102,169,3355536,3360185,4649,"zString"
"25712",17,2,96,170,3364191,3369350,5159,"zString"
"25912",17,2,104,171,3373069,3378584,5515,"zString"
"26014",17,3,147,172,3380324,3385767,5443,"zString"
"26115",17,2,94,173,3387538,3391884,4346,"zString"
"26310",17,3,126,174,3396068,3399784,3716,"zString"
"26511",17,2,108,175,3404630,3408452,3822,"zString"
"26611",17,2,113,176,3410564,3415168,4604,"zString"
"26712",17,3,137,177,3416888,3424735,7847,"zString"
"26814",17,3,144,178,3426343,3431402,5059,"zString"
"26911",17,3,143,179,3433264,3438519,5255,"zString"
"27013",17,2,106,180,3440218,3445169,4951,"zString"
"2718",17,2,114,181,3446915,3452352,5437,"zString"
"2722",17,3,142,182,3454296,3457786,3490,"zString"
"2733",17,2,119,183,3459477,3463270,3793,"zString"
"2742",17,2,116,184,3464971,3468870,3899,"zString"
"2751",17,2,120,185,3470616,3475803,5187,"zString"
"1070",18,1,36,1,4342410,4347646,5236,"zString"
"1260",18,1,41,2,4351542,4356513,4971,"zString"
"1419",18,1,32,3,4360622,4365446,4824,"zString"
"1659",18,1,48,4,4368800,4373747,4947,"zString"
"1740",18,1,43,5,4376267,4381747,5480,"zString"
"1850",18,1,49,6,4383278,4387464,4186,"zString"
"1940",18,1,33,7,4390370,4397164,6794,"zString"
"2150",18,1,54,8,4403081,4407815,4734,"zString"
"2270",18,1,60,9,4410142,4414281,4139,"zString"
"2370",18,1,56,10,4416357,4421231,4874,"zString"
"2450",18,1,57,11,4423385,4426998,3613,"zString"
"2570",18,1,52,12,4429278,4434366,5088,"zString"
"2650",18,1,35,13,4436793,4442416,5623,"zString"
"289",18,1,53,14,4446062,4450200,4138,"zString"
"2914",18,1,40,15,4451922,4456450,4528,"zString"
"3113",18,1,34,16,4460707,4465033,4326,"zString"
"3311",18,1,39,17,4469516,4473584,4068,"zString"
"3512",18,1,47,18,4479380,4485034,5654,"zString"
"3610",18,1,37,19,4487006,4490001,2995,"zString"
"3812",18,1,59,20,4494068,4499601,5533,"zString"
"3913",18,1,51,21,4501481,4506468,4987,"zString"
"4013",18,1,42,22,4508215,4512618,4403,"zString"
"4210",18,1,55,23,4516462,4521218,4756,"zString"
"4314",18,1,50,24,4523994,4527935,3941,"zString"
"4412",18,1,31,25,4530206,4534952,4746,"zString"
"4610",18,1,44,26,4540554,4545720,5166,"zString"
"4712",18,1,45,27,4548499,4552119,3620,"zString"
"4812",18,1,38,28,4553504,4557686,4182,"zString"
"5010",18,1,46,29,4561759,4565703,3944,"zString"
"5110",18,1,58,30,4567497,4576553,9056,"zString"
"5215",18,2,61,31,4579121,4583004,3883,"zString"
"5412",18,2,62,32,4587655,4591638,3983,"zString"
"5614",18,2,63,33,4596775,4601538,4763,"zString"
"5811",18,3,4,34,4605081,4609572,4491,"zString"
"6013",18,3,22,35,4613217,4617122,3905,"zString"
"6116",18,3,14,36,4619064,4622938,3874,"zString"
"626",18,3,12,37,4624727,4627789,3062,"zString"
"6411",18,2,70,38,4631911,4636022,4111,"zString"
"6610",18,3,13,39,4640168,4643372,3204,"zString"
"6711",18,3,6,40,4645084,4647506,2422,"zString"
"6911",18,3,15,41,4650933,4654840,3907,"zString"
"7014",18,2,65,42,4796686,4802061,5375,"zString"
"7211",18,2,84,43,4808583,4812545,3962,"zString"
"7313",18,3,25,44,4814207,4817262,3055,"zString"
"7414",18,3,17,45,4819176,4822129,2953,"zString"
"7510",18,2,87,46,4824462,4827262,2800,"zString"
"7615",18,2,71,47,4828656,4832312,3656,"zString"
"7810",18,2,89,48,4836612,4840129,3517,"zString"
"7914",18,3,10,49,4842123,4845463,3340,"zString"
"8111",18,2,78,50,4849755,4854029,4274,"zString"
"8211",18,3,29,51,4858508,4862696,4188,"zString"
"8312",18,2,72,52,4864523,4868630,4107,"zString"
"8511",18,2,82,53,4872540,4876397,3857,"zString"
"8610",18,2,90,54,4878296,4882130,3834,"zString"
"8711",18,3,28,55,4884365,4888297,3932,"zString"
"8813",18,3,21,56,4890047,4893314,3267,"zString"
"8912",18,3,9,57,4895246,4898164,2918,"zString"
"9114",18,3,8,58,4902725,4908098,5373,"zString"
"9310",18,2,64,59,4911678,4916549,4871,"zString"
"9515",18,3,27,60,4921618,4925149,3531,"zString"
"9613",18,3,23,61,4927174,4931799,4625,"zString"
"9712",18,2,68,62,4934508,4939649,5141,"zString"
"9913",18,2,66,63,4943601,4947416,3815,"zString"
"10117",18,2,77,64,4953246,4956816,3570,"zString"
"10217",18,3,1,65,4959130,4963083,3953,"zString"
"10413",18,2,76,66,4967075,4971984,4909,"zString"
"10512",18,2,88,67,4974211,4979267,5056,"zString"
"10613",18,3,16,68,4981053,4986218,5165,"zString"
"10712",18,3,2,69,4988369,4993118,4749,"zString"
"1099",18,3,20,70,4996880,5001701,4821,"zString"
"11013",18,2,75,71,5003752,5007985,4233,"zString"
"11113",18,3,7,72,5009809,5014485,4676,"zString"
"11314",18,3,26,73,5018294,5022202,3908,"zString"
"1149",18,3,11,74,5024238,5028169,3931,"zString"
"11615",18,2,80,75,5032532,5037902,5370,"zString"
"11712",18,2,86,76,5039465,5044019,4554,"zString"
"11810",18,3,5,77,5046030,5048669,2639,"zString"
"12015",18,3,3,78,5052788,5056920,4132,"zString"
"12214",18,3,19,79,5061050,5066153,5103,"zString"
"12312",18,2,74,80,5069925,5074054,4129,"zString"
"12411",18,2,85,81,5076172,5079954,3782,"zString"
"12514",18,2,69,82,5082495,5087970,5475,"zString"
"12714",18,2,79,83,5092743,5097571,4828,"zString"
"12811",18,3,30,84,5099613,5103838,4225,"zString"
"1299",18,2,81,85,5106029,5109655,3626,"zString"
"13015",18,2,67,86,5111509,5114755,3246,"zString"
"13213",18,2,83,87,5118513,5122439,3926,"zString"
"13313",18,2,73,88,5124938,5128439,3501,"zString"
"13411",18,3,24,89,5130252,5134289,4037,"zString"
"13512",18,3,18,90,5136396,5140139,3743,"zString"
"14514",18,1,139,91,5259687,5262160,2473,"reading"
"1464",18,1,141,92,5264026,5267810,3784,"reading"
"14713",18,1,140,93,5269544,5272193,2649,"reading"
"1484",18,1,143,94,5274340,5277660,3320,"reading"
"14916",18,1,123,95,5279387,5282611,3224,"reading"
"15116",18,1,148,96,5288446,5292644,4198,"reading"
"15212",18,1,121,97,5295660,5299961,4301,"reading"
"15411",18,1,150,98,5305201,5309061,3860,"reading"
"15514",18,1,135,99,5311055,5315162,4107,"reading"
"15611",18,1,132,100,5317150,5321845,4695,"reading"
"1589",18,1,136,101,5328600,5331346,2746,"reading"
"15914",18,1,134,102,5333290,5336596,3306,"reading"
"16011",18,1,144,103,5338341,5341779,3438,"reading"
"16119",18,1,126,104,5343912,5346879,2967,"reading"
"16312",18,1,131,105,5352099,5355197,3098,"reading"
"16510",18,1,137,106,5359774,5369347,9573,"reading"
"16614",18,1,147,107,5371214,5374480,3266,"reading"
"16713",18,1,129,108,5377284,5380597,3313,"reading"
"16910",18,1,133,109,5385815,5389964,4149,"reading"
"17013",18,1,149,110,5391763,5395231,3468,"reading"
"17116",18,1,124,111,5397467,5401565,4098,"reading"
"17311",18,1,127,112,5407400,5410715,3315,"reading"
"17512",18,1,130,113,5416005,5420965,4960,"reading"
"17712",18,1,146,114,5426057,5430183,4126,"reading"
"17810",18,1,138,115,5431974,5435282,3308,"reading"
"17914",18,1,128,116,5439095,5441816,2721,"reading"
"18114",18,1,145,117,5446999,5449783,2784,"reading"
"18214",18,1,125,118,5451944,5454200,2256,"reading"
"18412",18,1,122,119,5458367,5462284,3917,"reading"
"18610",18,1,142,120,5467909,5470617,2708,"reading"
"18715",18,2,151,121,5472510,5476451,3941,"reading"
"18914",18,2,152,122,5484445,5488702,4257,"reading"
"19115",18,2,153,123,5494972,5497701,2729,"reading"
"19313",18,2,170,124,5501906,5506402,4496,"reading"
"19413",18,3,94,125,5508345,5511218,2873,"reading"
"19612",18,2,177,126,5516948,5521153,4205,"reading"
"19713",18,3,119,127,5523193,5526836,3643,"reading"
"19811",18,2,171,128,5528684,5532319,3635,"reading"
"19910",18,3,114,129,5534121,5540736,6615,"reading"
"20014",18,3,95,130,5542575,5544820,2245,"reading"
"20212",18,2,167,131,5549724,5552653,2929,"reading"
"20313",18,2,166,132,5723002,5727626,4624,"reading"
"20411",18,3,91,133,5729773,5732809,3036,"reading"
"20611",18,2,176,134,5740935,5744726,3791,"reading"
"20714",18,2,162,135,5746387,5748693,2306,"reading"
"20914",18,2,163,136,5753146,5755910,2764,"reading"
"21012",18,2,157,137,5757635,5761210,3575,"reading"
"21213",18,2,173,138,5767212,5771177,3965,"reading"
"21311",18,3,105,139,5773125,5775977,2852,"reading"
"21412",18,2,174,140,5778539,5782461,3922,"reading"
"21513",18,2,169,141,5784255,5788211,3956,"reading"
"21611",18,2,165,142,5790405,5793929,3524,"reading"
"21714",18,2,154,143,5795782,5800278,4496,"reading"
"21913",18,3,107,144,5805102,5807145,2043,"reading"
"22011",18,2,160,145,5808832,5811862,3030,"reading"
"22213",18,2,159,146,5817626,5822113,4487,"reading"
"22413",18,3,109,147,5828315,5832363,4048,"reading"
"22513",18,3,110,148,5833961,5838013,4052,"reading"
"22612",18,2,179,149,5839694,5843246,3552,"reading"
"22711",18,2,178,150,5845071,5849513,4442,"reading"
"22813",18,3,112,151,5851419,5855197,3778,"reading"
"22912",18,2,175,152,5856816,5859430,2614,"reading"
"23012",18,2,156,153,5860810,5863814,3004,"reading"
"23215",18,3,108,154,5868553,5871614,3061,"reading"
"23313",18,2,172,155,5873550,5876914,3364,"reading"
"23414",18,3,120,156,5878594,5881964,3370,"reading"
"23511",18,3,99,157,5883908,5886248,2340,"reading"
"23712",18,2,180,158,5890698,5894348,3650,"reading"
"23811",18,3,100,159,5896012,5898982,2970,"reading"
"24010",18,2,158,160,5903607,5907732,4125,"reading"
"24214",18,3,93,161,5913460,5916349,2889,"reading"
"24414",18,3,98,162,5921194,5924699,3505,"reading"
"24613",18,3,116,163,5930364,5933017,2653,"reading"
"24712",18,3,113,164,5934978,5937650,2672,"reading"
"24810",18,2,155,165,5939398,5942567,3169,"reading"
"25010",18,2,161,166,5949680,5953350,3670,"reading"
"25213",18,3,118,167,5960786,5964684,3898,"reading"
"25313",18,3,92,168,5967405,5970184,2779,"reading"
"25513",18,3,96,169,5975440,5982851,7411,"reading"
"25713",18,3,101,170,5988101,5991435,3334,"reading"
"25913",18,2,168,171,5998735,6002135,3400,"reading"
"26015",18,3,104,172,6003690,6007419,3729,"reading"
"26116",18,3,111,173,6009682,6012102,2420,"reading"
"26212",18,3,106,174,6014099,6017769,3670,"reading"
"26311",18,3,103,175,6019928,6022919,2991,"reading"
"26412",18,3,117,176,6024638,6027986,3348,"reading"
"26512",18,3,102,177,6029977,6033069,3092,"reading"
"26713",18,3,115,178,6038257,6040820,2563,"reading"
"26815",18,3,97,179,6043592,6045854,2262,"reading"
"27014",18,2,164,180,6050533,6054703,4170,"reading"
"1080",19,2,31,1,7636469,7642657,6188,"reading"
"1270",19,2,32,2,7655948,7659841,3893,"reading"
"1420",19,2,33,3,7664817,7669208,4391,"reading"
"1660",19,2,50,4,7676991,7680541,3550,"reading"
"1750",19,3,66,5,7682736,7686608,3872,"reading"
"1950",19,3,68,6,7691717,7697126,5409,"reading"
"2160",19,2,36,7,7703688,7706909,3221,"reading"
"2380",19,3,84,8,7713505,7717026,3521,"reading"
"2460",19,3,77,9,7718888,7722576,3688,"reading"
"2580",19,2,37,10,7725537,7730793,5256,"reading"
"2719",19,2,39,11,7739704,7743810,4106,"reading"
"2915",19,3,62,12,7749083,7753211,4128,"reading"
"3114",19,3,74,13,7773110,7776878,3768,"reading"
"3215",19,2,42,14,7778715,7783862,5147,"reading"
"3410",19,3,63,15,7789029,7794629,5600,"reading"
"3611",19,2,40,16,7800335,7805612,5277,"reading"
"3813",19,2,46,17,7810743,7815080,4337,"reading"
"3914",19,2,54,18,7816642,7818913,2271,"reading"
"4014",19,2,58,19,7821780,7827113,5333,"reading"
"4115",19,2,56,20,7829405,7833013,3608,"reading"
"4211",19,2,45,21,7835299,7839564,4265,"reading"
"4315",19,3,69,22,7841352,7845247,3895,"reading"
"4514",19,2,41,23,7851537,7855131,3594,"reading"
"4713",19,3,73,24,7860019,7863881,3862,"reading"
"4813",19,3,86,25,7866285,7871882,5597,"reading"
"4915",19,3,79,26,7873667,7876415,2748,"reading"
"5011",19,3,81,27,7878038,7881699,3661,"reading"
"5111",19,3,71,28,7883272,7886965,3693,"reading"
"537",19,2,34,29,7892074,7895765,3691,"reading"
"556",19,2,38,30,7902248,7906582,4334,"reading"
"578",19,3,70,31,7911204,7915316,4112,"reading"
"5914",19,3,89,32,7919954,7924467,4513,"reading"
"6014",19,3,75,33,7925992,7930450,4458,"reading"
"6117",19,3,83,34,7932868,7936800,3932,"reading"
"627",19,2,43,35,7938166,7941217,3051,"reading"
"6317",19,3,67,36,7942929,7946434,3505,"reading"
"6514",19,2,47,37,7952009,7957701,5692,"reading"
"6611",19,3,88,38,7959432,7964401,4969,"reading"
"6712",19,2,57,39,7966633,7972018,5385,"reading"
"6813",19,3,76,40,7973961,7976185,2224,"reading"
"6912",19,3,80,41,7978084,7981668,3584,"reading"
"7015",19,3,90,42,8142181,8146442,4261,"reading"
"7112",19,2,48,43,8148035,8153476,5441,"reading"
"7212",19,2,51,44,8155056,8159760,4704,"reading"
"7314",19,2,55,45,8161337,8163993,2656,"reading"
"7415",19,2,44,46,8166477,8169277,2800,"reading"
"7511",19,2,52,47,8171063,8174977,3914,"reading"
"7616",19,2,49,48,8176814,8180860,4046,"reading"
"7711",19,3,64,49,8182579,8186627,4048,"reading"
"7915",19,3,78,50,8191860,8196161,4301,"reading"
"8012",19,3,65,51,8198907,8203594,4687,"reading"
"8212",19,2,53,52,8210207,8214261,4054,"reading"
"8313",19,2,60,53,8215891,8219645,3754,"reading"
"8413",19,3,85,54,8221723,8226212,4489,"reading"
"8512",19,3,61,55,8228363,8233328,4965,"reading"
"8712",19,2,35,56,8239964,8243046,3082,"reading"
"8913",19,3,82,57,8248732,8251979,3247,"reading"
"9015",19,2,59,58,8253419,8255763,2344,"reading"
"9115",19,3,72,59,8257519,8262096,4577,"reading"
"9311",19,3,87,60,8267776,8271663,3887,"reading"
"9412",19,1,3,61,8273299,8275997,2698,"reading"
"9614",19,1,1,62,8280267,8283631,3364,"reading"
"9813",19,1,26,63,8289138,8292831,3693,"reading"
"9914",19,1,25,64,8294773,8298831,4058,"reading"
"10013",19,1,5,65,8300810,8303464,2654,"reading"
"10218",19,1,7,66,8307949,8311598,3649,"reading"
"10414",19,1,15,67,8317524,8321415,3891,"reading"
"10513",19,1,30,68,8322991,8326465,3474,"reading"
"10614",19,1,17,69,8329116,8334615,5499,"reading"
"10713",19,1,11,70,8336276,8339616,3340,"reading"
"10910",19,1,14,71,8344359,8347933,3574,"reading"
"11014",19,1,6,72,8349532,8352733,3201,"reading"
"11212",19,1,13,73,8358701,8362299,3598,"reading"
"11315",19,1,27,74,8363979,8367300,3321,"reading"
"11410",19,1,4,75,8369020,8373683,4663,"reading"
"11616",19,1,12,76,8378170,8381567,3397,"reading"
"11811",19,1,2,77,8386094,8389867,3773,"reading"
"12016",19,1,20,78,8394893,8398851,3958,"reading"
"12115",19,1,22,79,8400678,8404235,3557,"reading"
"12215",19,1,21,80,8406691,8409451,2760,"reading"
"12313",19,1,10,81,8411302,8414335,3033,"reading"
"12515",19,1,19,82,8418614,8421952,3338,"reading"
"12611",19,1,24,83,8423517,8428102,4585,"reading"
"12715",19,1,28,84,8430466,8433918,3452,"reading"
"12812",19,1,23,85,8435742,8439885,4143,"reading"
"12910",19,1,8,86,8442302,8447203,4901,"reading"
"13111",19,1,18,87,8451936,8456969,5033,"reading"
"13214",19,1,29,88,8458592,8462120,3528,"reading"
"13314",19,1,9,89,8463824,8468453,4629,"reading"
"13513",19,1,16,90,8472809,8476470,3661,"reading"
"14515",19,2,121,91,8565650,8568740,3090,"zString"
"14714",19,2,122,92,8575619,8578940,3321,"zString"
"14917",19,2,123,93,8583759,8588024,4265,"zString"
"15117",19,3,178,94,8592191,8595524,3333,"zString"
"15213",19,2,146,95,8597545,8602525,4980,"zString"
"15311",19,3,172,96,8604781,8611275,6494,"zString"
"15412",19,3,177,97,8613117,8618758,5641,"zString"
"15515",19,2,136,98,8620737,8625008,4271,"zString"
"15612",19,2,143,99,8628857,8633609,4752,"zString"
"15714",19,2,137,100,8637871,8641076,3205,"zString"
"15810",19,3,154,101,8643265,8646243,2978,"zString"
"16012",19,2,150,102,8650998,8653743,2745,"zString"
"16120",19,2,124,103,8655558,8659126,3568,"zString"
"16313",19,2,135,104,8664985,8669527,4542,"zString"
"16415",19,3,153,105,8671782,8676561,4779,"zString"
"16615",19,3,151,106,8680904,8686077,5173,"zString"
"16813",19,3,167,107,8690347,8694494,4147,"zString"
"16911",19,3,162,108,8696608,8699128,2520,"zString"
"17117",19,2,132,109,8703281,8707045,3764,"zString"
"17312",19,2,147,110,8711642,8715012,3370,"zString"
"17413",19,3,175,111,8718750,8722612,3862,"zString"
"17513",19,2,125,112,8724380,8728495,4115,"zString"
"17713",19,2,131,113,8733492,8737729,4237,"zString"
"17915",19,2,140,114,8741372,8746129,4757,"zString"
"18014",19,2,129,115,8748144,8752713,4569,"zString"
"18215",19,3,158,116,8756365,8760280,3915,"zString"
"18413",19,3,159,117,8764645,8769464,4819,"zString"
"18611",19,3,161,118,8773935,8777097,3162,"zString"
"1887",19,3,165,119,8786193,8790464,4271,"zString"
"18915",19,2,142,120,8792632,8795431,2799,"zString"
"1909",19,2,128,121,8797653,8802131,4478,"zString"
"19212",19,3,157,122,8807589,8812182,4593,"zString"
"19414",19,3,169,123,8816128,8819398,3270,"zString"
"19512",19,2,133,124,8821215,8824815,3600,"zString"
"19613",19,2,144,125,8826626,8831399,4773,"zString"
"19714",19,2,138,126,8834675,8837816,3141,"zString"
"19812",19,3,179,127,8839750,8843149,3399,"zString"
"19911",19,2,127,128,8845414,8849066,3652,"zString"
"20118",19,2,148,129,8854864,8858433,3569,"zString"
"20213",19,3,156,130,8860543,8864833,4290,"zString"
"20412",19,3,170,131,8868424,8871633,3209,"zString"
"20515",19,3,173,132,9038956,9041773,2817,"zString"
"20612",19,3,176,133,9043501,9045589,2088,"zString"
"20715",19,3,155,134,9047464,9050190,2726,"zString"
"20915",19,2,145,135,9055556,9058156,2600,"zString"
"21013",19,2,141,136,9060057,9063007,2950,"zString"
"21117",19,3,164,137,9064960,9069208,4248,"zString"
"21214",19,2,130,138,9073397,9077007,3610,"zString"
"21413",19,3,174,139,9081231,9084675,3444,"zString"
"21514",19,3,152,140,9086709,9089875,3166,"zString"
"21715",19,3,180,141,9093622,9097891,4269,"zString"
"21813",19,2,149,142,9101963,9106392,4429,"zString"
"21914",19,3,166,143,9109546,9113225,3679,"zString"
"22012",19,2,134,144,9114971,9118576,3605,"zString"
"22119",19,2,126,145,9122635,9126342,3707,"zString"
"22313",19,2,139,146,9130206,9134859,4653,"zString"
"22414",19,3,160,147,9137090,9140792,3702,"zString"
"22613",19,3,168,148,9144232,9148228,3996,"zString"
"22712",19,3,163,149,9150152,9155610,5458,"zString"
"22814",19,3,171,150,9157743,9161127,3384,"zString"
"22913",19,1,103,151,9165480,9169010,3530,"zString"
"23013",19,1,96,152,9170676,9174644,3968,"zString"
"23216",19,1,118,153,9178986,9182461,3475,"zString"
"23314",19,1,113,154,9184046,9187611,3565,"zString"
"23415",19,1,102,155,9190558,9193694,3136,"zString"
"23614",19,1,93,156,9197821,9202111,4290,"zString"
"23812",19,1,109,157,9207926,9210278,2352,"zString"
"23911",19,1,105,158,9211899,9214995,3096,"zString"
"24011",19,1,94,159,9216675,9219128,2453,"zString"
"24215",19,1,117,160,9223274,9225529,2255,"zString"
"24313",19,1,92,161,9231149,9235496,4347,"zString"
"24514",19,1,91,162,9242034,9245697,3663,"zString"
"24713",19,1,98,163,9249592,9253029,3437,"zString"
"24912",19,1,110,164,9257027,9259847,2820,"zString"
"25011",19,1,95,165,9261955,9265830,3875,"zString"
"25214",19,1,100,166,9270129,9274514,4385,"zString"
"25412",19,1,112,167,9278810,9282214,3404,"zString"
"25514",19,1,119,168,9285242,9288648,3406,"zString"
"25611",19,1,106,169,9290536,9294415,3879,"zString"
"25714",19,1,115,170,9296345,9298898,2553,"zString"
"25810",19,1,104,171,9301053,9304215,3162,"zString"
"25914",19,1,116,172,9306824,9311065,4241,"zString"
"26016",19,1,97,173,9313103,9317365,4262,"zString"
"26213",19,1,111,174,9321188,9324499,3311,"zString"
"26312",19,1,107,175,9326832,9330099,3267,"zString"
"26413",19,1,108,176,9335009,9338583,3574,"zString"
"26513",19,1,114,177,9340303,9345701,5398,"zString"
"26612",19,1,120,178,9349141,9353483,4342,"zString"
"26714",19,1,101,179,9355048,9358900,3852,"zString"
"26912",19,1,99,180,9363534,9367683,4149,"zString"
"1090",20,2,1,1,12486665,12490089,3424,"zString"
"1280",20,2,2,2,12494660,12497523,2863,"zString"
"1421",20,2,3,3,12502377,12505256,2879,"zString"
"1670",20,3,59,4,12508810,12511540,2730,"zString"
"1760",20,2,25,5,12513556,12515673,2117,"zString"
"1860",20,3,40,6,12518488,12521990,3502,"zString"
"2040",20,2,28,7,12527834,12530757,2923,"zString"
"2170",20,3,44,8,12534167,12537491,3324,"zString"
"2280",20,3,49,9,12539757,12541641,1884,"zString"
"2390",20,2,7,10,12545501,12549158,3657,"zString"
"2590",20,3,58,11,12553904,12555908,2004,"zString"
"2660",20,3,43,12,12561150,12563725,2575,"zString"
"2720",20,3,35,13,12567186,12569959,2773,"zString"
"2916",20,3,51,14,12574561,12578975,4414,"zString"
"3015",20,2,23,15,12581996,12584726,2730,"zString"
"3115",20,2,18,16,12586207,12588459,2252,"zString"
"3216",20,3,46,17,12590781,12594259,3478,"zString"
"3312",20,2,6,18,12596061,12598059,1998,"zString"
"3513",20,2,26,19,12604000,12608043,4043,"zString"
"3612",20,2,27,20,12610692,12613877,3185,"zString"
"3716",20,2,17,21,12615460,12618543,3083,"zString"
"3814",20,3,53,22,12620674,12622760,2086,"zString"
"3915",20,2,13,23,12628535,12630844,2309,"zString"
"4015",20,3,60,24,12633976,12637427,3451,"zString"
"4116",20,2,21,25,12643088,12645095,2007,"zString"
"4212",20,3,55,26,12646793,12650061,3268,"zString"
"4316",20,3,41,27,12651927,12653878,1951,"zString"
"4515",20,2,24,28,12659605,12663145,3540,"zString"
"4611",20,2,19,29,12669208,12672379,3171,"zString"
"4714",20,3,54,30,12675246,12677696,2450,"zString"
"4814",20,2,30,31,12680698,12683096,2398,"zString"
"4916",20,2,14,32,12686679,12688862,2183,"zString"
"5012",20,2,20,33,12693702,12696847,3145,"zString"
"5112",20,3,37,34,12700305,12702613,2308,"zString"
"538",20,2,8,35,12707723,12713813,6090,"zString"
"557",20,3,31,36,12718150,12724631,6481,"zString"
"579",20,2,12,37,12731590,12734581,2991,"zString"
"5915",20,3,57,38,12739649,12741681,2032,"zString"
"6015",20,3,32,39,12744805,12749915,5110,"zString"
"628",20,2,10,40,12755055,12757198,2143,"zString"
"6412",20,3,39,41,12762400,12764949,2549,"zString"
"6612",20,3,34,42,12936002,12938471,2469,"zString"
"6814",20,3,47,43,12945936,12948321,2385,"zString"
"6913",20,2,15,44,12951649,12955255,3606,"zString"
"7016",20,3,56,45,12957254,12960788,3534,"zString"
"7113",20,3,36,46,12963970,12967789,3819,"zString"
"7315",20,3,38,47,12972538,12975589,3051,"zString"
"7512",20,2,16,48,12980604,12983156,2552,"zString"
"7617",20,3,52,49,12989600,12992306,2706,"zString"
"7712",20,3,33,50,12994411,12997206,2795,"zString"
"7916",20,2,11,51,13001518,13004757,3239,"zString"
"8112",20,2,29,52,13009654,13012690,3036,"zString"
"8213",20,3,48,53,13017029,13021224,4195,"zString"
"8314",20,3,50,54,13025043,13027424,2381,"zString"
"8414",20,2,9,55,13031040,13032891,1851,"zString"
"8611",20,2,5,56,13039458,13041791,2333,"zString"
"8814",20,2,22,57,13047326,13049925,2599,"zString"
"8914",20,3,45,58,13057092,13059842,2750,"zString"
"9016",20,3,42,59,13062260,13064359,2099,"zString"
"9214",20,2,4,60,13073332,13076209,2877,"zString"
"9413",20,1,87,61,13081309,13083459,2150,"zString"
"9516",20,1,83,62,13086707,13088893,2186,"zString"
"9615",20,1,66,63,13091245,13093826,2581,"zString"
"9814",20,1,64,64,13099464,13102443,2979,"zString"
"10014",20,1,82,65,13114502,13117877,3375,"zString"
"10118",20,1,69,66,13120963,13122960,1997,"zString"
"10313",20,1,80,67,13127613,13130061,2448,"zString"
"10415",20,1,61,68,13132690,13134978,2288,"zString"
"10615",20,1,72,69,13139617,13142428,2811,"zString"
"10814",20,1,78,70,13147216,13149545,2329,"zString"
"10911",20,1,68,71,13153203,13155978,2775,"zString"
"11114",20,1,63,72,13161118,13165462,4344,"zString"
"11316",20,1,81,73,13171525,13173345,1820,"zString"
"11411",20,1,77,74,13179078,13180946,1868,"zString"
"11512",20,1,67,75,13183334,13185479,2145,"zString"
"11713",20,1,70,76,13189636,13192380,2744,"zString"
"11913",20,1,86,77,13196542,13201046,4504,"zString"
"12017",20,1,73,78,13204402,13206080,1678,"zString"
"12116",20,1,62,79,13208501,13210530,2029,"zString"
"12314",20,1,84,80,13215687,13218914,3227,"zString"
"12412",20,1,85,81,13221256,13222964,1708,"zString"
"12612",20,1,76,83,13250980,13253665,2685,"zString"
"12716",20,1,89,84,13255885,13257865,1980,"zString"
"12813",20,1,90,85,13263382,13265916,2534,"zString"
"12911",20,1,71,86,13270582,13273866,3284,"zString"
"13112",20,1,79,87,13279011,13281333,2322,"zString"
"13215",20,1,75,88,13285009,13288283,3274,"zString"
"13315",20,1,65,89,13290782,13292800,2018,"zString"
"13514",20,1,74,90,13300870,13303600,2730,"zString"
"1363",20,1,88,91,13305600,13309283,3683,"zString"
"1465",20,2,91,92,13583062,13586812,3750,"reading"
"1485",20,2,92,93,13597191,13602763,5572,"reading"
"1506",20,2,93,94,13608789,13614430,5641,"reading"
"15214",20,3,148,95,13621337,13631580,10243,"reading"
"15312",20,2,117,96,13634592,13638030,3438,"reading"
"15413",20,3,135,97,13641776,13650981,9205,"reading"
"15516",20,2,111,98,13654158,13677182,23024,"reading"
"15613",20,3,133,99,13679588,13683749,4161,"reading"
"15715",20,3,149,100,13686997,13694982,7985,"reading"
"15811",20,2,98,101,13699355,13706549,7194,"reading"
"16013",20,3,137,102,13717031,13728417,11386,"reading"
"16121",20,2,109,103,13733193,13737567,4374,"reading"
"16216",20,2,95,104,13741625,13751568,9943,"reading"
"16416",20,2,104,105,13759261,13765085,5824,"reading"
"16511",20,3,121,106,13767278,13779652,12374,"reading"
"16714",20,3,125,107,13793577,13797036,3459,"reading"
"16912",20,2,112,108,13802301,13806053,3752,"reading"
"17014",20,3,144,109,13810857,13818420,7563,"reading"
"17118",20,2,94,110,13822602,13830387,7785,"reading"
"17313",20,3,145,111,13838481,13843004,4523,"reading"
"17414",20,3,138,112,13847200,13858038,10838,"reading"
"17514",20,3,141,113,13865871,13877088,11217,"reading"
"17613",20,2,120,114,13883911,13887472,3561,"reading"
"17714",20,2,101,115,13892360,13896606,4246,"reading"
"17916",20,2,115,116,13904008,13908856,4848,"reading"
"18015",20,2,96,117,13914528,13917023,2495,"reading"
"18216",20,3,128,118,13923955,13935107,11152,"reading"
"18414",20,3,150,119,13942583,13954108,11525,"reading"
"18512",20,3,127,120,13960409,13970375,9966,"reading"
"18716",20,3,136,121,13990265,13995559,5294,"reading"
"1888",20,2,100,122,14000712,14004893,4181,"reading"
"19010",20,2,107,123,14012836,14017427,4591,"reading"
"19116",20,2,114,124,14019400,14024860,5460,"reading"
"19213",20,3,143,125,14026845,14031444,4599,"reading"
"19314",20,2,97,126,14034897,14038644,3747,"reading"
"19513",20,3,130,127,14046187,14059178,12991,"reading"
"19715",20,3,146,128,14066139,14072529,6390,"reading"
"19813",20,3,126,129,14075160,14085029,9869,"reading"
"20015",20,3,147,130,14092689,14098680,5991,"reading"
"20119",20,3,132,131,14101549,14104796,3247,"reading"
"20314",20,2,118,132,14113237,14117447,4210,"reading"
"20413",20,3,124,133,14283146,14287952,4806,"reading"
"20613",20,2,116,134,14293650,14296970,3320,"reading"
"20716",20,2,102,135,14299988,14304703,4715,"reading"
"20916",20,3,134,136,14312572,14316403,3831,"reading"
"21014",20,3,142,137,14318456,14322154,3698,"reading"
"21118",20,2,105,138,14324263,14327987,3724,"reading"
"21215",20,2,106,139,14329825,14335787,5962,"reading"
"21312",20,2,103,140,14337952,14344904,6952,"reading"
"21414",20,3,131,141,14346796,14350338,3542,"reading"
"21612",20,3,140,142,14360932,14364755,3823,"reading"
"21716",20,3,139,143,14366302,14368988,2686,"reading"
"21814",20,2,113,144,14370630,14382122,11492,"reading"
"21915",20,2,108,145,14384360,14388189,3829,"reading"
"22013",20,3,129,146,14390329,14397190,6861,"reading"
"22214",20,2,119,147,14411123,14415023,3900,"reading"
"22314",20,2,99,148,14416963,14420207,3244,"reading"
"22514",20,3,122,149,14425003,14432857,7854,"reading"
"22713",20,2,110,150,14438433,14441791,3358,"reading"
"22815",20,3,123,151,14444246,14448724,4478,"reading"
"23014",20,1,163,152,14454388,14458858,4470,"reading"
"23116",20,1,162,153,14461848,14467742,5894,"reading"
"23315",20,1,180,154,14478207,14484676,6469,"reading"
"23512",20,1,169,156,14508295,14511960,3665,"reading"
"23615",20,1,159,157,14513847,14521677,7830,"reading"
"23813",20,1,179,158,14529021,14534444,5423,"reading"
"23912",20,1,171,159,14536060,14540994,4934,"reading"
"24012",20,1,158,160,14542763,14548061,5298,"reading"
"24216",20,1,178,161,14554769,14559861,5092,"reading"
"24314",20,1,170,162,14561618,14567612,5994,"reading"
"24415",20,1,174,163,14569612,14573045,3433,"reading"
"24515",20,1,161,164,14574887,14584779,9892,"reading"
"24714",20,1,166,165,14594112,14600213,6101,"reading"
"24811",20,1,172,166,14602442,14606513,4071,"reading"
"24913",20,1,164,167,14608533,14618331,9798,"reading"
"25012",20,1,153,168,14621148,14629398,8250,"reading"
"25215",20,1,152,169,14635132,14641648,6516,"reading"
"25413",20,1,151,170,14647872,14652282,4410,"reading"
"25612",20,1,167,171,14661557,14664782,3225,"reading"
"25715",20,1,175,172,14666924,14679115,12191,"reading"
"25811",20,1,157,173,14681279,14689249,7970,"reading"
"26017",20,1,173,174,14694601,14698450,3849,"reading"
"26117",20,1,154,175,14700382,14704750,4368,"reading"
"26313",20,1,177,176,14709665,14714383,4718,"reading"
"26414",20,1,160,177,14716604,14721901,5297,"reading"
"26613",20,1,155,178,14728784,14742168,13384,"reading"
"26816",20,1,165,179,14748689,14754402,5713,"reading"
"26913",20,1,176,180,14756144,14760002,3858,"reading"
"27015",20,1,156,181,14761885,14769119,7234,"reading"
"2723",20,1,168,182,14775711,14780869,5158,"reading"
"10100",21,1,42,1,763544,766733,3189,"reading"
"1290",21,1,41,2,772059,774650,2591,"reading"
"1422",21,1,54,3,779504,781534,2030,"reading"
"1540",21,1,36,4,783007,785367,2360,"reading"
"1770",21,1,31,5,790974,793368,2394,"reading"
"1960",21,1,32,6,801260,803668,2408,"reading"
"2180",21,1,45,7,809294,811168,1874,"reading"
"2290",21,1,59,8,814213,815779,1566,"reading"
"23100",21,1,44,9,818258,821435,3177,"reading"
"2470",21,1,39,10,823354,826519,3165,"reading"
"2670",21,1,34,11,833269,835219,1950,"reading"
"2810",21,1,35,12,841906,844386,2480,"reading"
"3016",21,1,49,13,850091,852853,2762,"reading"
"3116",21,1,50,14,854848,856620,1772,"reading"
"3217",21,1,57,15,858485,861504,3019,"reading"
"3313",21,1,53,16,865742,868404,2662,"reading"
"3411",21,1,60,17,870307,872887,2580,"reading"
"3514",21,1,51,18,874460,878104,3644,"reading"
"3613",21,1,58,19,880599,883137,2538,"reading"
"3717",21,1,38,20,884919,887054,2135,"reading"
"3916",21,1,48,21,892128,894621,2493,"reading"
"4016",21,1,52,22,898373,901305,2932,"reading"
"4117",21,1,46,23,903255,905605,2350,"reading"
"4213",21,1,47,24,907328,910921,3593,"reading"
"4317",21,1,56,25,912940,914605,1665,"reading"
"4413",21,1,37,26,916311,918088,1777,"reading"
"4612",21,1,55,27,923602,925540,1938,"reading"
"4715",21,1,33,28,927477,929539,2062,"reading"
"4917",21,1,40,29,935180,937339,2159,"reading"
"5113",21,1,43,30,942725,945123,2398,"reading"
"5216",21,2,61,31,947520,954040,6520,"reading"
"5413",21,2,62,32,959552,962556,3004,"reading"
"5615",21,2,63,33,967711,971557,3846,"reading"
"5812",21,2,64,34,977073,980024,2951,"reading"
"6016",21,2,81,35,985274,989441,4167,"reading"
"6118",21,2,72,36,991884,995341,3457,"reading"
"6318",21,2,84,37,999865,1002291,2426,"reading"
"6413",21,2,66,38,1003849,1006975,3126,"reading"
"6613",21,2,75,39,1013457,1016610,3153,"reading"
"6713",21,3,21,40,1018543,1025159,6616,"reading"
"6815",21,3,4,41,1026916,1033092,6176,"reading"
"7017",21,3,30,42,1199271,1203998,4727,"reading"
"7114",21,3,3,43,1206664,1209182,2518,"reading"
"7316",21,2,69,44,1216360,1218784,2424,"reading"
"7513",21,2,73,45,1224186,1226449,2263,"reading"
"7618",21,3,9,46,1228263,1229899,1636,"reading"
"7811",21,3,26,47,1234138,1235966,1828,"reading"
"7917",21,2,74,48,1239403,1241399,1996,"reading"
"8013",21,2,67,49,1243413,1244617,1204,"reading"
"8214",21,3,12,50,1250803,1253200,2397,"reading"
"8415",21,2,65,51,1259045,1264467,5422,"reading"
"8612",21,2,88,52,1270064,1272417,2353,"reading"
"8713",21,3,11,53,1274346,1277469,3123,"reading"
"8915",21,3,1,54,1283400,1285585,2185,"reading"
"9116",21,3,10,55,1289499,1292851,3352,"reading"
"9312",21,2,87,56,1297727,1300868,3141,"reading"
"9414",21,3,18,57,1302943,1306052,3109,"reading"
"9517",21,3,14,58,1308161,1314119,5958,"reading"
"9616",21,3,2,59,1316204,1320419,4215,"reading"
"9815",21,2,85,60,1325518,1329086,3568,"reading"
"9915",21,3,16,61,1330722,1332820,2098,"reading"
"10015",21,3,28,62,1335093,1337320,2227,"reading"
"10119",21,3,13,63,1339421,1341569,2148,"reading"
"10219",21,2,78,64,1345227,1347553,2326,"reading"
"10314",21,2,80,65,1349304,1351653,2349,"reading"
"10416",21,3,15,66,1353548,1356069,2521,"reading"
"10514",21,2,83,67,1357859,1359804,1945,"reading"
"10616",21,2,77,68,1361621,1363204,1583,"reading"
"10714",21,2,79,69,1365382,1367420,2038,"reading"
"10815",21,3,17,70,1370812,1374087,3275,"reading"
"10912",21,2,86,71,1378319,1380004,1685,"reading"
"11015",21,3,5,72,1382341,1385071,2730,"reading"
"11213",21,3,29,73,1389589,1391905,2316,"reading"
"11317",21,3,24,74,1393724,1395971,2247,"reading"
"11412",21,3,6,75,1397812,1400004,2192,"reading"
"11617",21,2,89,76,1404730,1406489,1759,"reading"
"11714",21,3,7,77,1407988,1410173,2185,"reading"
"11914",21,3,19,78,1415193,1418606,3413,"reading"
"12018",21,2,90,79,1420372,1422406,2034,"reading"
"12117",21,2,70,80,1424446,1426356,1910,"reading"
"12315",21,2,82,81,1433088,1435456,2368,"reading"
"12413",21,3,25,82,1437409,1438973,1564,"reading"
"12516",21,3,23,83,1440763,1442923,2160,"reading"
"12613",21,3,8,84,1446770,1449107,2337,"reading"
"12814",21,2,71,85,1453842,1455973,2131,"reading"
"13016",21,3,20,86,1460832,1463409,2577,"reading"
"13113",21,2,68,87,1479626,1482591,2965,"reading"
"13316",21,3,27,88,1488523,1491027,2504,"reading"
"13412",21,3,22,89,1492637,1494325,1688,"reading"
"13515",21,2,76,90,1497497,1499141,1644,"reading"
"14516",21,1,121,91,1577456,1579513,2057,"zString"
"14715",21,1,150,92,1583730,1585461,1731,"zString"
"1486",21,1,137,93,1587327,1589711,2384,"zString"
"14918",21,1,124,94,1593185,1595978,2793,"zString"
"15118",21,1,126,95,1600526,1603728,3202,"zString"
"15313",21,1,143,96,1608162,1610812,2650,"zString"
"15414",21,1,144,97,1612676,1615828,3152,"zString"
"15517",21,1,138,98,1620084,1622146,2062,"zString"
"15614",21,1,130,99,1623997,1627146,3149,"zString"
"15812",21,1,149,100,1632299,1634480,2181,"zString"
"15915",21,1,142,101,1638000,1640880,2880,"zString"
"16014",21,1,129,102,1642866,1645529,2663,"zString"
"16217",21,1,134,103,1649791,1651697,1906,"zString"
"16314",21,1,146,104,1653682,1656664,2982,"zString"
"16417",21,1,141,105,1659925,1662147,2222,"zString"
"16512",21,1,128,106,1664612,1668131,3519,"zString"
"16715",21,1,145,107,1671974,1673648,1674,"zString"
"16814",21,1,147,108,1676879,1678964,2085,"zString"
"16913",21,1,148,109,1681280,1684864,3584,"zString"
"17015",21,1,127,110,1687849,1690816,2967,"zString"
"17215",21,1,123,111,1695059,1697498,2439,"zString"
"17415",21,1,125,112,1702174,1704682,2508,"zString"
"17614",21,1,131,113,1708345,1710866,2521,"zString"
"17811",21,1,132,114,1715347,1718315,2968,"zString"
"18016",21,1,122,115,1722906,1725066,2160,"zString"
"18217",21,1,133,116,1729892,1732216,2324,"zString"
"18311",21,1,136,117,1734599,1737251,2652,"zString"
"18415",21,1,135,118,1740578,1743483,2905,"zString"
"18513",21,1,139,119,1745843,1747600,1757,"zString"
"18612",21,1,140,120,1750474,1752700,2226,"zString"
"18717",21,2,151,121,1756347,1759700,3353,"zString"
"18916",21,2,152,122,1764483,1767934,3451,"zString"
"19117",21,2,153,123,1772865,1774984,2119,"zString"
"19315",21,3,106,124,1779830,1782302,2472,"zString"
"19415",21,2,175,125,1784566,1786201,1635,"zString"
"19514",21,2,177,126,1788382,1789818,1436,"zString"
"19614",21,3,116,127,1793288,1795435,2147,"zString"
"19716",21,3,108,128,1797408,1800285,2877,"zString"
"19814",21,2,170,129,1802177,1804168,1991,"zString"
"19912",21,3,97,130,1806722,1809185,2463,"zString"
"20120",21,2,158,131,1813204,1815186,1982,"zString"
"20315",21,3,95,132,2043460,2047312,3852,"zString"
"20516",21,2,178,133,2051634,2053927,2293,"zString"
"20614",21,2,167,134,2056540,2059111,2571,"zString"
"20717",21,3,120,135,2062167,2064011,1844,"zString"
"20813",21,2,165,136,2067535,2069128,1593,"zString"
"20917",21,3,99,137,2071047,2072378,1331,"zString"
"21119",21,3,102,138,2076703,2080211,3508,"zString"
"21313",21,3,109,139,2084117,2086461,2344,"zString"
"21415",21,3,117,140,2088884,2090262,1378,"zString"
"21515",21,3,91,141,2096248,2098612,2364,"zString"
"21717",21,3,111,142,2102944,2104362,1418,"zString"
"21815",21,3,92,143,2106819,2108646,1827,"zString"
"22014",21,3,107,144,2113944,2117113,3169,"zString"
"22120",21,2,155,145,2120109,2121830,1721,"zString"
"22315",21,2,176,146,2127192,2129496,2304,"zString"
"22415",21,2,168,147,2131471,2133398,1927,"zString"
"22515",21,3,100,148,2136225,2137947,1722,"zString"
"22714",21,3,110,149,2142758,2144197,1439,"zString"
"22816",21,3,118,150,2146463,2148097,1634,"zString"
"22914",21,2,169,151,2150541,2152347,1806,"zString"
"23015",21,2,166,152,2154445,2155947,1502,"zString"
"23117",21,3,101,153,2158938,2160247,1309,"zString"
"23316",21,3,98,154,2165649,2167731,2082,"zString"
"23513",21,2,159,155,2172172,2174064,1892,"zString"
"23713",21,3,105,156,2180430,2182148,1718,"zString"
"23814",21,3,113,157,2184218,2185965,1747,"zString"
"23913",21,2,171,158,2187685,2189298,1613,"zString"
"24013",21,3,112,159,2191333,2193332,1999,"zString"
"24116",21,3,104,160,2196710,2197082,372,"zString"
"24217",21,2,156,161,2200167,2201915,1748,"zString"
"24416",21,2,179,162,2207862,2209849,1987,"zString"
"24516",21,3,114,163,2212135,2213700,1565,"zString"
"24614",21,3,96,164,2215470,2218150,2680,"zString"
"24812",21,3,115,165,2222540,2224466,1926,"zString"
"24914",21,2,180,166,2226670,2228766,2096,"zString"
"25013",21,3,103,167,2231620,2233618,1998,"zString"
"25118",21,3,93,168,2236730,2238500,1770,"zString"
"25314",21,3,119,169,2243001,2244517,1516,"zString"
"25414",21,2,154,170,2247394,2248551,1157,"zString"
"25613",21,2,164,171,2253789,2255887,2098,"zString"
"25716",21,2,174,172,2260454,2262184,1730,"zString"
"25812",21,2,160,173,2264424,2266734,2310,"zString"
"26018",21,2,161,174,2271548,2273085,1537,"zString"
"26214",21,2,163,175,2278303,2279752,1449,"zString"
"26314",21,2,157,176,2282822,2284635,1813,"zString"
"26514",21,3,94,177,2289297,2290934,1637,"zString"
"26715",21,2,162,178,2294555,2296018,1463,"zString"
"26914",21,2,172,179,2301066,2304052,2986,"zString"
"27016",21,2,173,180,2306966,2308819,1853,"zString"
"10101",22,1,21,1,4374912,4379953,5041,"zString"
"1120",22,1,1,2,4382950,4386670,3720,"zString"
"1330",22,1,23,3,4391848,4396153,4305,"zString"
"1423",22,1,28,4,4397809,4402570,4761,"zString"
"1550",22,1,2,5,4405071,4409037,3966,"zString"
"1780",22,1,17,6,4413455,4417304,3849,"zString"
"1870",22,1,8,7,4418884,4423954,5070,"zString"
"2050",22,1,25,8,4428438,4431421,2983,"zString"
"2190",22,1,14,9,4433004,4436388,3384,"zString"
"22100",22,1,19,10,4439310,4443255,3945,"zString"
"23101",22,1,30,11,4444904,4449472,4568,"zString"
"2480",22,1,26,12,4451933,4455539,3606,"zString"
"25100",22,1,15,13,4457536,4461956,4420,"zString"
"2680",22,1,3,14,4463544,4467506,3962,"zString"
"2811",22,1,9,15,4471837,4475223,3386,"zString"
"3017",22,1,5,16,4481261,4485390,4129,"zString"
"3218",22,1,13,17,4490400,4493507,3107,"zString"
"3314",22,1,27,18,4495861,4499890,4029,"zString"
"3412",22,1,20,19,4501388,4505907,4519,"zString"
"3515",22,1,10,20,4508892,4512474,3582,"zString"
"3718",22,1,12,21,4522683,4526208,3525,"zString"
"3917",22,1,11,22,4530326,4534408,4082,"zString"
"4118",22,1,7,23,4538616,4543558,4942,"zString"
"4318",22,1,22,24,4552223,4558226,6003,"zString"
"4414",22,1,18,25,4560539,4565492,4953,"zString"
"4516",22,1,24,26,4570206,4574843,4637,"zString"
"4613",22,1,4,27,4576847,4582159,5312,"zString"
"4815",22,1,29,28,4587241,4592160,4919,"zString"
"4918",22,1,16,29,4593767,4598243,4476,"zString"
"5013",22,1,6,30,4600342,4605310,4968,"zString"
"5217",22,2,31,31,4611995,4618011,6016,"zString"
"5414",22,2,32,32,4622736,4628295,5559,"zString"
"5616",22,2,33,33,4633610,4638395,4785,"zString"
"5813",22,3,81,34,4644024,4647545,3521,"zString"
"5916",22,2,47,35,4652138,4655812,3674,"zString"
"6017",22,2,55,36,4657662,4661479,3817,"zString"
"6119",22,3,61,37,4663384,4666895,3511,"zString"
"6319",22,2,45,38,4673905,4677846,3941,"zString"
"6414",22,2,44,39,4681563,4685130,3567,"zString"
"6515",22,3,83,40,4686822,4690513,3691,"zString"
"6614",22,2,52,41,4693074,4697297,4223,"zString"
"6714",22,2,40,42,4845435,4850018,4583,"zString"
"6914",22,2,49,43,4854486,4857969,3483,"zString"
"7018",22,3,90,44,4860054,4863669,3615,"zString"
"7115",22,2,60,45,4865311,4869386,4075,"zString"
"7213",22,2,58,46,4871152,4875153,4001,"zString"
"7317",22,3,69,47,4876981,4880403,3422,"zString"
"7514",22,3,68,48,4886490,4890720,4230,"zString"
"7713",22,3,74,49,4895755,4899954,4199,"zString"
"7812",22,2,48,50,4901703,4905804,4101,"zString"
"7918",22,2,36,51,4907547,4911287,3740,"zString"
"8113",22,3,82,52,4915817,4921171,5354,"zString"
"8215",22,3,86,53,4923552,4927188,3636,"zString"
"8315",22,3,87,54,4929249,4933272,4023,"zString"
"8416",22,3,79,55,4935010,4939172,4162,"zString"
"8513",22,2,39,56,4941132,4944939,3807,"zString"
"8714",22,2,34,57,4949219,4953972,4753,"zString"
"8916",22,3,75,58,4958618,4963023,4405,"zString"
"9017",22,2,51,59,4964958,4972006,7048,"zString"
"9117",22,2,42,60,4973886,4977506,3620,"zString"
"9313",22,3,78,61,4981905,4985523,3618,"zString"
"9415",22,3,76,62,4987145,4991123,3978,"zString"
"9518",22,2,54,63,4992981,4996257,3276,"zString"
"9617",22,3,85,64,4998642,5001740,3098,"zString"
"9713",22,3,63,65,5004001,5007107,3106,"zString"
"9916",22,2,35,66,5011167,5014658,3491,"zString"
"10120",22,2,46,67,5019383,5022808,3425,"zString"
"10220",22,3,77,68,5024762,5027825,3063,"zString"
"10315",22,3,88,69,5029468,5033708,4240,"zString"
"10417",22,3,80,70,5035206,5039575,4369,"zString"
"10515",22,3,84,71,5042714,5047192,4478,"zString"
"10617",22,3,62,72,5048672,5053576,4904,"zString"
"10816",22,2,41,73,5057653,5062092,4439,"zString"
"11016",22,2,57,74,5066293,5070559,4266,"zString"
"11115",22,3,66,75,5073639,5077260,3621,"zString"
"11318",22,3,73,76,5081285,5084026,2741,"zString"
"11413",22,3,71,77,5085539,5089627,4088,"zString"
"11618",22,3,65,78,5093894,5098810,4916,"zString"
"11812",22,3,67,79,5102468,5105677,3209,"zString"
"12019",22,2,38,80,5110087,5113694,3607,"zString"
"12216",22,2,53,81,5117704,5121078,3374,"zString"
"12316",22,3,72,82,5122816,5127512,4696,"zString"
"12517",22,3,70,83,5132236,5136545,4309,"zString"
"12717",22,2,43,84,5140975,5144912,3937,"zString"
"12815",22,2,56,85,5146567,5150363,3796,"zString"
"12912",22,3,64,86,5151901,5155962,4061,"zString"
"13114",22,2,37,87,5160402,5163996,3594,"zString"
"13317",22,3,89,88,5168980,5172596,3616,"zString"
"13413",22,2,50,89,5175606,5179280,3674,"zString"
"13516",22,2,59,90,5182135,5185213,3078,"zString"
"14517",22,1,118,91,5570871,5578393,7522,"reading"
"1466",22,1,110,92,5580079,5584210,4131,"reading"
"14716",22,1,116,93,5585867,5590110,4243,"reading"
"1487",22,1,96,94,5592558,5596977,4419,"reading"
"1507",22,1,109,95,5603386,5606511,3125,"reading"
"15119",22,1,111,96,5609006,5612444,3438,"reading"
"15215",22,1,117,97,5614032,5619528,5496,"reading"
"15314",22,1,93,98,5621142,5626645,5503,"reading"
"15518",22,1,99,99,5631913,5635862,3949,"reading"
"15716",22,1,119,100,5640697,5645495,4798,"reading"
"15813",22,1,114,101,5647187,5655679,8492,"reading"
"15916",22,1,102,102,5657204,5661163,3959,"reading"
"16122",22,1,112,103,5669173,5673430,4257,"reading"
"16218",22,1,103,104,5675239,5680880,5641,"reading"
"16315",22,1,95,105,5682633,5686147,3514,"reading"
"16513",22,1,92,106,5691704,5695897,4193,"reading"
"16716",22,1,115,107,5702076,5704881,2805,"reading"
"16815",22,1,105,108,5706743,5710964,4221,"reading"
"16914",22,1,101,109,5712532,5715331,2799,"reading"
"17119",22,1,120,110,5720750,5724615,3865,"reading"
"17216",22,1,91,111,5726230,5732216,5986,"reading"
"17416",22,1,108,112,5738615,5745232,6617,"reading"
"17515",22,1,106,113,5746983,5750449,3466,"reading"
"17615",22,1,113,114,5752808,5756983,4175,"reading"
"17715",22,1,94,115,5758563,5761933,3370,"reading"
"17917",22,1,100,116,5768833,5774433,5600,"reading"
"18115",22,1,104,117,5780184,5783867,3683,"reading"
"18218",22,1,98,118,5785582,5791017,5435,"reading"
"18416",22,1,107,119,5797021,5800501,3480,"reading"
"18514",22,1,97,120,5802460,5805434,2974,"reading"
"18718",22,2,121,121,5810894,5817068,6174,"reading"
"18917",22,2,122,122,5823812,5828218,4406,"reading"
"19118",22,2,123,123,5833191,5837452,4261,"reading"
"19316",22,2,142,124,5842810,5847336,4526,"reading"
"19416",22,3,164,125,5849253,5857203,7950,"reading"
"19515",22,3,154,126,5858834,5862553,3719,"reading"
"19717",22,2,143,127,5866457,5870120,3663,"reading"
"19815",22,3,171,128,5871659,5876020,4361,"reading"
"19913",22,2,137,129,5877697,5882253,4556,"reading"
"20016",22,3,177,130,5884053,5888987,4934,"reading"
"20121",22,2,149,131,5891231,5896088,4857,"reading"
"20214",22,3,151,132,6052144,6055876,3732,"reading"
"20414",22,2,147,133,6061917,6065543,3626,"reading"
"20517",22,3,152,134,6067191,6073977,6786,"reading"
"20718",22,2,127,135,6079819,6083277,3458,"reading"
"20918",22,3,176,136,6088456,6094577,6121,"reading"
"21015",22,2,130,137,6096142,6099478,3336,"reading"
"21216",22,3,167,138,6104819,6108478,3659,"reading"
"21314",22,3,153,139,6110134,6115862,5728,"reading"
"21516",22,2,134,140,6119802,6122912,3110,"reading"
"21613",22,3,165,141,6124464,6130412,5948,"reading"
"21718",22,3,157,142,6131976,6136129,4153,"reading"
"21916",22,2,129,143,6140459,6143346,2887,"reading"
"22121",22,2,140,144,6147941,6152013,4072,"reading"
"22215",22,3,180,145,6153650,6159696,6046,"reading"
"22316",22,3,163,146,6161311,6164563,3252,"reading"
"22416",22,2,139,147,6166358,6170597,4239,"reading"
"22516",22,2,131,148,6172112,6176564,4452,"reading"
"22715",22,3,168,149,6181262,6184481,3219,"reading"
"22817",22,3,156,150,6186028,6193764,7736,"reading"
"23016",22,2,126,151,6202960,6207898,4938,"reading"
"23217",22,2,135,152,6213566,6216515,2949,"reading"
"23317",22,3,170,153,6218004,6223582,5578,"reading"
"23416",22,3,172,154,6225365,6228499,3134,"reading"
"23514",22,2,124,155,6230132,6236282,6150,"reading"
"23714",22,3,173,156,6241682,6245332,3650,"reading"
"23815",22,3,179,157,6246959,6250666,3707,"reading"
"23914",22,2,133,158,6252179,6255583,3404,"reading"
"24014",22,3,161,159,6257327,6261716,4389,"reading"
"24218",22,3,162,160,6267077,6269800,2723,"reading"
"24417",22,2,148,161,6275770,6279534,3764,"reading"
"24517",22,3,175,162,6281299,6284867,3568,"reading"
"24615",22,3,158,163,6286638,6292868,6230,"reading"
"24813",22,2,145,164,6300936,6303718,2782,"reading"
"24915",22,2,138,165,6305293,6309868,4575,"reading"
"25014",22,2,128,166,6311647,6314135,2488,"reading"
"25216",22,2,136,167,6319295,6322819,3524,"reading"
"25315",22,3,160,168,6324670,6329219,4549,"reading"
"25515",22,3,159,169,6335262,6340186,4924,"reading"
"25717",22,2,141,170,6345483,6352270,6787,"reading"
"25813",22,2,125,171,6354202,6358270,4068,"reading"
"26019",22,3,155,172,6363555,6369287,5732,"reading"
"26215",22,2,146,173,6375677,6378671,2994,"reading"
"26315",22,2,132,174,6380338,6385037,4699,"reading"
"26515",22,2,150,175,6390298,6394471,4173,"reading"
"26614",22,3,178,176,6396230,6401372,5142,"reading"
"26716",22,3,169,177,6402966,6406755,3789,"reading"
"26817",22,2,144,178,6408248,6414938,6690,"reading"
"26915",22,3,166,179,6416632,6420922,4290,"reading"
"27017",22,3,174,180,6422913,6427122,4209,"reading"
"10102",23,2,1,1,4064333,4072706,8373,"reading"
"12100",23,2,2,2,4077131,4085023,7892,"reading"
"1424",23,2,3,3,4089748,4093540,3792,"reading"
"1680",23,3,37,4,4098937,4105341,6404,"reading"
"1880",23,3,54,5,4112552,4116741,4189,"reading"
"1970",23,2,7,6,4121350,4126574,5224,"reading"
"21100",23,2,21,7,4133899,4146927,13028,"reading"
"22101",23,3,46,8,4150477,4159360,8883,"reading"
"23102",23,3,34,9,4161650,4166009,4359,"reading"
"25101",23,2,8,10,4172397,4177426,5029,"reading"
"2724",23,2,30,11,4183029,4189510,6481,"reading"
"2812",23,3,57,12,4198522,4203961,5439,"reading"
"2917",23,3,51,13,4207794,4213961,6167,"reading"
"3018",23,2,25,14,4216164,4223961,7797,"reading"
"3117",23,3,32,15,4227057,4231595,4538,"reading"
"3315",23,3,52,16,4240141,4246162,6021,"reading"
"3413",23,2,20,17,4251077,4258129,7052,"reading"
"3516",23,3,48,18,4267102,4273664,6562,"reading"
"3614",23,2,17,19,4277338,4281730,4392,"reading"
"3719",23,2,28,20,4287940,4292164,4224,"reading"
"3815",23,2,11,21,4296761,4301781,5020,"reading"
"4017",23,3,49,22,4308278,4315548,7270,"reading"
"4119",23,2,13,23,4318565,4322898,4333,"reading"
"4214",23,3,42,24,4326259,4331682,5423,"reading"
"4415",23,3,59,25,4340483,4342999,2516,"reading"
"4517",23,3,33,26,4348696,4355099,6403,"reading"
"4716",23,3,41,27,4364359,4368916,4557,"reading"
"4919",23,2,14,28,4388405,4393234,4829,"reading"
"5014",23,3,44,29,4395127,4398000,2873,"reading"
"5114",23,3,47,30,4399971,4407068,7097,"reading"
"5218",23,2,29,31,4409047,4413018,3971,"reading"
"539",23,2,10,32,4414752,4418851,4099,"reading"
"558",23,3,40,33,4423750,4427118,3368,"reading"
"5710",23,3,53,34,4432562,4436319,3757,"reading"
"5814",23,2,26,35,4438325,4442686,4361,"reading"
"5917",23,3,39,36,4445013,4456069,11056,"reading"
"6120",23,3,60,37,4460467,4464053,3586,"reading"
"629",23,2,22,38,4465888,4470320,4432,"reading"
"6320",23,2,9,39,4472381,4475320,2939,"reading"
"6516",23,2,15,40,4479804,4487004,7200,"reading"
"6615",23,2,24,41,4489003,4496504,7501,"reading"
"6715",23,3,55,42,4673251,4677777,4526,"reading"
"6816",23,3,50,43,4679696,4684160,4464,"reading"
"6915",23,2,16,44,4686246,4691910,5664,"reading"
"7019",23,3,36,45,4694215,4697728,3513,"reading"
"7214",23,2,23,46,4703077,4706744,3667,"reading"
"7318",23,3,45,47,4708334,4714430,6096,"reading"
"7416",23,3,58,48,4716562,4722463,5901,"reading"
"7515",23,2,4,49,4725285,4729995,4710,"reading"
"7714",23,3,31,50,4735564,4742812,7248,"reading"
"7919",23,3,43,51,4749939,4761263,11324,"reading"
"8014",23,2,19,52,4763628,4770114,6486,"reading"
"8114",23,2,6,53,4772618,4780081,7463,"reading"
"8316",23,3,56,54,4787920,4792647,4727,"reading"
"8417",23,3,35,55,4794724,4798048,3324,"reading"
"8613",23,2,12,56,4803199,4809432,6233,"reading"
"8815",23,2,27,57,4815067,4819949,4882,"reading"
"8917",23,2,5,58,4823712,4827999,4287,"reading"
"9118",23,2,18,59,4844432,4849767,5335,"reading"
"9215",23,3,38,60,4851613,4855066,3453,"reading"
"9416",23,1,90,61,4860075,4867817,7742,"reading"
"9519",23,1,85,62,4869848,4877969,8121,"reading"
"9618",23,1,82,63,4881232,4886867,5635,"reading"
"9714",23,1,75,64,4889552,4893602,4050,"reading"
"9816",23,1,88,65,4895669,4900968,5299,"reading"
"9917",23,1,78,66,4902881,4908801,5920,"reading"
"10016",23,1,62,67,4910491,4914602,4111,"reading"
"10221",23,1,73,68,4919493,4924519,5026,"reading"
"10316",23,1,84,69,4926271,4929852,3581,"reading"
"10418",23,1,65,70,4931605,4939370,7765,"reading"
"10618",23,1,81,71,4944580,4954520,9940,"reading"
"10715",23,1,64,72,4956457,4962437,5980,"reading"
"10913",23,1,69,73,4967758,4972204,4446,"reading"
"11116",23,1,66,74,4977398,4981171,3773,"reading"
"11319",23,1,89,75,4985511,4988638,3127,"reading"
"11414",23,1,61,76,4990393,4995321,4928,"reading"
"11619",23,1,63,77,5000324,5007922,7598,"reading"
"11813",23,1,87,78,5014823,5019989,5166,"reading"
"11915",23,1,72,79,5021860,5024972,3112,"reading"
"12118",23,1,68,80,5029500,5033656,4156,"reading"
"12317",23,1,86,81,5038392,5042908,4516,"reading"
"12414",23,1,71,82,5044870,5050673,5803,"reading"
"12614",23,1,74,83,5054965,5060456,5491,"reading"
"12718",23,1,80,84,5062351,5065942,3591,"reading"
"12816",23,1,76,85,5067513,5071857,4344,"reading"
"12913",23,1,77,86,5074880,5078824,3944,"reading"
"13017",23,1,67,87,5080583,5084658,4075,"reading"
"13216",23,1,83,88,5089473,5092992,3519,"reading"
"13318",23,1,79,89,5094705,5100491,5786,"reading"
"13414",23,1,70,90,5102276,5105642,3366,"reading"
"14518",23,2,91,91,5351722,5356050,4328,"zString"
"14717",23,2,92,92,5359998,5364602,4604,"zString"
"14919",23,2,93,93,5369464,5372534,3070,"zString"
"15120",23,2,112,94,5377574,5381819,4245,"zString"
"15216",23,2,120,95,5384905,5389752,4847,"zString"
"15315",23,2,115,96,5391788,5395202,3414,"zString"
"15415",23,2,108,97,5397761,5402935,5174,"zString"
"15519",23,3,149,98,5404876,5410585,5709,"zString"
"15615",23,3,124,99,5413397,5418719,5322,"zString"
"15814",23,2,95,100,5424022,5429352,5330,"zString"
"16015",23,2,119,101,5434876,5439455,4579,"zString"
"16123",23,2,96,102,5442171,5447137,4966,"zString"
"16316",23,3,138,103,5467011,5470489,3478,"zString"
"16418",23,3,133,104,5472301,5474906,2605,"zString"
"16514",23,2,117,105,5476598,5479139,2541,"zString"
"16616",23,2,100,106,5480957,5484640,3683,"zString"
"16816",23,3,142,107,5489178,5493140,3962,"zString"
"16915",23,3,140,108,5494786,5499023,4237,"zString"
"17016",23,3,126,109,5500727,5505990,5263,"zString"
"17217",23,3,123,110,5510121,5514691,4570,"zString"
"17417",23,3,144,111,5518783,5523508,4725,"zString"
"17516",23,2,98,112,5525139,5529441,4302,"zString"
"17716",23,3,139,113,5533321,5537641,4320,"zString"
"17812",23,3,145,114,5539446,5543308,3862,"zString"
"17918",23,3,141,115,5546410,5550075,3665,"zString"
"18017",23,2,109,116,5551842,5554492,2650,"zString"
"18116",23,3,137,117,5556173,5559709,3536,"zString"
"18219",23,3,128,118,5562531,5568409,5878,"zString"
"18417",23,2,102,119,5572473,5575909,3436,"zString"
"18613",23,2,104,120,5579524,5582926,3402,"zString"
"18719",23,2,106,121,5584477,5589610,5133,"zString"
"1889",23,2,103,122,5591325,5596510,5185,"zString"
"18918",23,3,129,123,5599978,5602744,2766,"zString"
"19119",23,3,134,124,5607265,5611728,4463,"zString"
"19214",23,3,121,125,5613714,5617111,3397,"zString"
"19417",23,3,125,126,5621648,5626561,4913,"zString"
"19615",23,3,131,127,5630273,5634195,3922,"zString"
"19816",23,3,122,128,5638030,5641328,3298,"zString"
"20017",23,2,110,129,5645149,5648679,3530,"zString"
"20122",23,2,94,130,5650568,5653929,3361,"zString"
"20316",23,3,150,131,5658201,5661412,3211,"zString"
"20415",23,3,127,132,5882826,5886636,3810,"zString"
"20615",23,2,118,133,5891154,5894071,2917,"zString"
"20719",23,2,105,134,5896484,5899387,2903,"zString"
"20814",23,2,113,135,5901553,5905072,3519,"zString"
"20919",23,3,148,136,5907575,5912971,5396,"zString"
"21016",23,3,143,137,5915235,5919689,4454,"zString"
"21120",23,2,107,138,5922002,5925571,3569,"zString"
"21217",23,2,97,139,5928143,5931371,3228,"zString"
"21416",23,2,99,140,5962384,5966740,4356,"zString"
"21614",23,3,147,141,5971664,5975257,3593,"zString"
"21719",23,3,136,142,5977146,5982057,4911,"zString"
"21816",23,2,101,143,5983727,5987323,3596,"zString"
"22015",23,3,135,144,5991431,5995707,4276,"zString"
"22122",23,2,114,145,5997452,6000374,2922,"zString"
"22216",23,2,116,146,6002443,6006174,3731,"zString"
"22317",23,3,146,147,6007964,6013608,5644,"zString"
"22417",23,2,111,148,6016213,6020591,4378,"zString"
"22517",23,3,132,149,6022676,6026975,4299,"zString"
"22716",23,3,130,150,6030878,6034858,3980,"zString"
"22915",23,1,161,151,6038690,6041959,3269,"zString"
"23118",23,1,159,152,6046061,6051959,5898,"zString"
"23318",23,1,155,153,6055678,6058926,3248,"zString"
"23515",23,1,151,154,6063317,6067393,4076,"zString"
"23715",23,1,179,155,6071099,6075412,4313,"zString"
"23816",23,1,163,156,6077417,6081793,4376,"zString"
"23915",23,1,177,157,6083708,6087910,4202,"zString"
"24015",23,1,164,158,6089747,6096394,6647,"zString"
"24117",23,1,156,159,6098155,6102744,4589,"zString"
"24315",23,1,162,160,6106568,6109811,3243,"zString"
"24518",23,1,180,161,6113869,6117578,3709,"zString"
"24616",23,1,158,162,6119437,6123178,3741,"zString"
"24814",23,1,176,163,6127703,6131262,3559,"zString"
"24916",23,1,171,164,6133209,6137779,4570,"zString"
"25015",23,1,178,165,6139437,6145213,5776,"zString"
"25119",23,1,165,166,6147084,6152979,5895,"zString"
"25217",23,1,168,167,6154855,6159013,4158,"zString"
"25316",23,1,153,168,6160786,6166113,5327,"zString"
"25516",23,1,175,169,6170279,6174863,4584,"zString"
"25614",23,1,172,170,6176889,6180947,4058,"zString"
"25718",23,1,167,171,6183296,6188047,4751,"zString"
"25814",23,1,154,172,6190041,6193864,3823,"zString"
"26020",23,1,174,173,6197754,6202631,4877,"zString"
"26118",23,1,169,174,6204267,6208048,3781,"zString"
"26216",23,1,173,175,6209817,6214248,4431,"zString"
"26316",23,1,160,176,6215814,6220082,4268,"zString"
"26516",23,1,170,177,6223603,6228166,4563,"zString"
"26615",23,1,157,178,6230025,6236198,6173,"zString"
"26818",23,1,152,179,6240216,6246016,5800,"zString"
"27018",23,1,166,180,6249772,6252799,3027,"zString"
"10103",24,2,61,1,8436894,8440422,3528,"zString"
"12101",24,2,62,2,8445532,8449056,3524,"zString"
"1425",24,2,63,3,8453517,8457572,4055,"zString"
"1690",24,2,71,4,8462278,8468840,6562,"zString"
"1890",24,3,21,5,8473329,8476690,3361,"zString"
"1980",24,3,1,6,8478695,8481540,2845,"zString"
"21101",24,3,23,7,8485718,8491040,5322,"zString"
"22102",24,2,74,8,8495002,8499174,4172,"zString"
"23103",24,3,11,9,8500987,8505457,4470,"zString"
"25102",24,2,68,10,8509814,8514008,4194,"zString"
"2725",24,2,81,11,8518530,8522258,3728,"zString"
"2813",24,2,87,12,8524413,8527825,3412,"zString"
"2918",24,3,6,13,8529939,8533309,3370,"zString"
"3118",24,2,88,14,8537395,8541942,4547,"zString"
"3219",24,2,82,15,8544731,8548509,3778,"zString"
"3316",24,3,8,16,8551722,8555625,3903,"zString"
"3517",24,2,67,17,8563559,8567459,3900,"zString"
"3720",24,2,72,18,8572028,8576277,4249,"zString"
"3918",24,3,5,19,8580967,8583877,2910,"zString"
"4120",24,2,65,20,8588461,8591477,3016,"zString"
"4319",24,2,86,21,8596962,8599728,2766,"zString"
"4416",24,3,26,22,8602710,8605794,3084,"zString"
"4518",24,3,22,23,8608471,8611094,2623,"zString"
"4614",24,3,20,24,8612916,8617994,5078,"zString"
"4717",24,3,13,25,8621135,8624428,3293,"zString"
"4816",24,3,12,26,8627552,8632145,4593,"zString"
"5015",24,2,69,27,8636500,8639445,2945,"zString"
"5219",24,2,76,28,8643430,8648745,5315,"zString"
"5310",24,2,80,29,8651180,8657379,6199,"zString"
"5415",24,2,66,30,8659625,8662346,2721,"zString"
"5617",24,2,89,31,8666241,8670630,4389,"zString"
"5711",24,2,77,32,8672578,8675680,3102,"zString"
"5815",24,3,9,33,8678056,8681147,3091,"zString"
"6018",24,2,79,34,8685958,8691497,5539,"zString"
"6121",24,3,30,35,8693198,8697114,3916,"zString"
"6210",24,3,2,36,8699112,8702064,2952,"zString"
"6415",24,2,70,37,8707237,8712598,5361,"zString"
"6616",24,3,7,38,8717013,8722432,5419,"zString"
"6817",24,2,78,39,8726516,8732432,5916,"zString"
"6916",24,3,4,40,8734389,8739499,5110,"zString"
"7116",24,3,10,41,8743785,8747682,3897,"zString"
"7319",24,2,90,42,8899579,8903321,3742,"zString"
"7417",24,3,17,43,8905035,8907838,2803,"zString"
"7516",24,3,29,44,8909877,8912205,2328,"zString"
"7619",24,2,64,45,8913829,8917038,3209,"zString"
"7813",24,3,27,46,8920886,8924088,3202,"zString"
"7920",24,3,24,47,8925780,8928872,3092,"zString"
"8015",24,2,73,48,8930377,8932789,2412,"zString"
"8115",24,2,85,49,8935498,8938389,2891,"zString"
"8216",24,3,15,50,8940163,8945239,5076,"zString"
"8317",24,2,84,51,8946653,8950056,3403,"zString"
"8418",24,3,14,52,8951976,8955256,3280,"zString"
"8514",24,2,75,53,8957428,8960440,3012,"zString"
"8614",24,3,3,54,8961947,8965573,3626,"zString"
"8816",24,2,83,55,8969879,8972624,2745,"zString"
"8918",24,3,25,56,8974131,8976440,2309,"zString"
"9018",24,3,18,57,8978295,8980707,2412,"zString"
"9119",24,3,16,58,8982697,8985974,3277,"zString"
"9216",24,3,19,59,8987781,8990674,2893,"zString"
"9314",24,3,28,60,8992252,8994791,2539,"zString"
"9417",24,1,33,61,8996283,8999041,2758,"zString"
"9619",24,1,57,62,9003084,9005591,2507,"zString"
"9715",24,1,43,63,9007556,9010708,3152,"zString"
"9817",24,1,38,64,9012264,9014475,2211,"zString"
"10017",24,1,54,65,9018527,9020558,2031,"zString"
"10121",24,1,52,66,9022035,9025808,3773,"zString"
"10222",24,1,37,67,9027377,9029808,2431,"zString"
"10419",24,1,49,68,9033600,9035559,1959,"zString"
"10516",24,1,47,69,9037170,9039976,2806,"zString"
"10619",24,1,55,70,9042192,9044793,2601,"zString"
"10716",24,1,59,71,9046603,9048959,2356,"zString"
"10817",24,1,32,72,9050523,9053709,3186,"zString"
"11017",24,1,51,73,9057970,9060893,2923,"zString"
"11117",24,1,36,74,9062407,9065593,3186,"zString"
"11320",24,1,60,75,9069246,9072494,3248,"zString"
"11415",24,1,46,76,9074186,9076777,2591,"zString"
"11513",24,1,53,77,9078561,9081127,2566,"zString"
"11620",24,1,56,78,9082891,9085861,2970,"zString"
"11715",24,1,34,79,9087281,9090411,3130,"zString"
"11916",24,1,31,80,9095112,9098628,3516,"zString"
"12119",24,1,35,81,9103047,9106294,3247,"zString"
"12318",24,1,40,82,9110354,9113612,3258,"zString"
"12518",24,1,50,83,9117024,9119212,2188,"zString"
"12615",24,1,39,84,9121243,9123745,2502,"zString"
"12817",24,1,44,85,9127886,9130296,2410,"zString"
"12914",24,1,41,86,9132305,9134862,2557,"zString"
"13115",24,1,45,87,9138838,9141246,2408,"zString"
"13217",24,1,58,88,9142930,9145480,2550,"zString"
"13319",24,1,42,89,9148237,9150996,2759,"zString"
"13517",24,1,48,90,9155377,9158413,3036,"zString"
"14519",24,2,151,91,9374377,9377871,3494,"reading"
"14718",24,2,152,92,9382600,9386988,4388,"reading"
"14920",24,2,153,93,9391777,9396188,4411,"reading"
"15121",24,3,119,94,9399978,9404988,5010,"reading"
"15217",24,2,166,95,9406739,9410705,3966,"reading"
"15316",24,3,120,96,9412327,9417105,4778,"reading"
"15416",24,3,112,97,9419565,9423506,3941,"reading"
"15520",24,2,169,98,9425668,9430539,4871,"reading"
"15616",24,2,174,99,9432358,9437623,5265,"reading"
"15717",24,3,102,100,9440192,9444340,4148,"reading"
"15917",24,2,159,101,9449382,9453640,4258,"reading"
"16124",24,2,154,102,9459386,9462474,3088,"reading"
"16317",24,2,156,103,9467929,9473424,5495,"reading"
"16515",24,3,99,104,9478029,9481007,2978,"reading"
"16717",24,2,177,105,9485315,9489324,4009,"reading"
"16817",24,2,173,106,9491054,9494158,3104,"reading"
"16916",24,3,114,107,9496012,9500091,4079,"reading"
"17017",24,2,155,108,9501968,9507308,5340,"reading"
"17218",24,3,107,109,9512080,9514209,2129,"reading"
"17314",24,3,118,110,9515845,9518175,2330,"reading"
"17418",24,3,111,111,9520254,9522309,2055,"reading"
"17517",24,2,175,112,9523897,9526426,2529,"reading"
"17616",24,3,96,113,9529421,9533326,3905,"reading"
"17813",24,2,161,114,9538764,9541043,2279,"reading"
"18018",24,2,168,115,9545630,9548476,2846,"reading"
"18117",24,2,160,116,9550351,9553660,3309,"reading"
"18312",24,2,164,117,9558872,9561694,2822,"reading"
"18418",24,3,109,118,9563194,9567210,4016,"reading"
"18515",24,2,167,119,9568802,9571478,2676,"reading"
"18614",24,2,171,120,9573031,9576827,3796,"reading"
"18720",24,3,94,121,9578258,9581094,2836,"reading"
"18919",24,3,110,122,9585968,9589311,3343,"reading"
"19011",24,3,113,123,9591021,9593695,2674,"reading"
"19120",24,2,157,124,9596827,9600145,3318,"reading"
"19317",24,2,165,125,9604648,9611845,7197,"reading"
"19418",24,3,116,126,9613694,9618895,5201,"reading"
"19516",24,2,172,127,9620664,9624162,3498,"reading"
"19616",24,2,180,128,9626120,9630863,4743,"reading"
"19718",24,3,92,129,9638208,9641363,3155,"reading"
"19914",24,2,178,130,9646216,9649646,3430,"reading"
"20018",24,2,176,131,9651381,9654413,3032,"reading"
"20123",24,3,95,132,9798880,9801402,2522,"reading"
"20317",24,3,106,133,9805753,9809502,3749,"reading"
"20416",24,2,162,134,9811062,9813069,2007,"reading"
"20616",24,2,163,135,9817533,9820702,3169,"reading"
"20720",24,2,179,136,9823406,9825269,1863,"reading"
"20815",24,3,117,137,9827006,9829353,2347,"reading"
"20920",24,3,97,138,9830972,9834020,3048,"reading"
"21121",24,3,100,139,9838425,9841136,2711,"reading"
"21315",24,3,91,140,9845737,9850820,5083,"reading"
"21517",24,3,108,141,9855808,9858620,2812,"reading"
"21615",24,3,115,142,9860435,9863571,3136,"reading"
"21720",24,3,101,143,9865406,9867654,2248,"reading"
"21917",24,3,98,144,9871523,9874004,2481,"reading"
"22123",24,2,170,145,9878202,9880671,2469,"reading"
"22217",24,3,104,146,9882330,9887071,4741,"reading"
"22318",24,3,103,147,9889505,9893471,3966,"reading"
"22418",24,2,158,148,9894858,9897788,2930,"reading"
"22614",24,3,93,149,9902060,9904989,2929,"reading"
"22818",24,3,105,150,9909748,9913389,3641,"reading"
"22916",24,1,141,151,9915147,9918956,3809,"reading"
"23017",24,1,122,152,9920410,9922922,2512,"reading"
"23218",24,1,134,153,9926962,9930856,3894,"reading"
"23319",24,1,140,154,9932300,9934573,2273,"reading"
"23417",24,1,148,155,9936237,9938323,2086,"reading"
"23516",24,1,145,156,9940063,9941890,1827,"reading"
"23616",24,1,146,157,9943402,9946023,2621,"reading"
"23716",24,1,139,158,9947628,9949623,1995,"reading"
"23817",24,1,142,159,9951146,9954240,3094,"reading"
"23916",24,1,124,160,9955719,9959057,3338,"reading"
"24118",24,1,129,161,9964865,9966940,2075,"reading"
"24316",24,1,150,162,9971443,9974541,3098,"reading"
"24418",24,1,138,163,9976012,9980808,4796,"reading"
"24519",24,1,125,164,9982311,9984475,2164,"reading"
"24715",24,1,147,165,9988574,9991592,3018,"reading"
"24815",24,1,143,166,9993227,9995409,2182,"reading"
"24917",24,1,126,167,9997033,9999592,2559,"reading"
"25120",24,1,131,168,10004207,10007192,2985,"reading"
"25317",24,1,123,169,10011857,10016059,4202,"reading"
"25517",24,1,136,170,10020455,10022726,2271,"reading"
"25615",24,1,144,171,10024193,10027226,3033,"reading"
"25719",24,1,137,172,10028772,10031260,2488,"reading"
"25815",24,1,128,173,10032938,10034876,1938,"reading"
"26021",24,1,149,174,10039008,10042010,3002,"reading"
"26119",24,1,132,175,10043884,10046610,2726,"reading"
"26317",24,1,133,176,10050894,10054027,3133,"reading"
"26415",24,1,130,177,10056023,10060494,4471,"reading"
"26616",24,1,127,178,10064830,10066777,1947,"reading"
"26819",24,1,121,179,10071386,10073661,2275,"reading"
"27019",24,1,135,180,10077466,10080178,2712,"reading"
"10104",25,1,24,1,11768478,11774722,6244,"reading"
"1130",25,1,6,2,11777403,11783556,6153,"reading"
"1340",25,1,16,3,11791042,11796439,5397,"reading"
"1426",25,1,2,4,11798618,11803856,5238,"reading"
"16100",25,1,30,5,11811606,11816590,4984,"reading"
"1790",25,1,23,6,11818780,11822874,4094,"reading"
"18100",25,1,14,7,11824707,11830841,6134,"reading"
"1990",25,1,3,8,11833262,11836740,3478,"reading"
"21102",25,1,13,9,11842800,11849808,7008,"reading"
"22103",25,1,18,10,11851732,11859542,7810,"reading"
"23104",25,1,10,11,11861528,11867492,5964,"reading"
"25103",25,1,9,12,11874249,11878026,3777,"reading"
"2726",25,1,26,13,11882991,11886326,3335,"reading"
"2814",25,1,4,14,11888250,11893693,5443,"reading"
"3019",25,1,21,15,11900079,11910127,10048,"reading"
"3119",25,1,20,16,11911906,11916360,4454,"reading"
"3220",25,1,12,17,11918040,11922160,4120,"reading"
"3414",25,1,25,18,11927048,11931127,4079,"reading"
"3518",25,1,15,19,11933527,11936961,3434,"reading"
"3615",25,1,28,20,11939180,11942328,3148,"reading"
"3721",25,1,11,21,11944125,11949194,5069,"reading"
"3919",25,1,29,22,11954043,11959278,5235,"reading"
"4018",25,1,8,23,11961461,11965028,3567,"reading"
"4215",25,1,19,24,11970384,11973862,3478,"reading"
"4320",25,1,17,25,11975763,11984346,8583,"reading"
"4417",25,1,7,26,11986416,11992696,6280,"reading"
"4615",25,1,1,27,11997431,12001696,4265,"reading"
"4817",25,1,22,28,12006103,12009463,3360,"reading"
"4920",25,1,5,29,12012317,12015431,3114,"reading"
"5115",25,1,27,30,12019881,12023364,3483,"reading"
"5220",25,2,31,31,12025228,12036414,11186,"reading"
"5416",25,2,32,32,12040902,12046965,6063,"reading"
"5618",25,2,33,33,12053068,12058865,5797,"reading"
"5816",25,2,57,34,12063644,12067782,4138,"reading"
"5918",25,3,74,35,12070200,12076699,6499,"reading"
"6019",25,3,66,36,12078476,12086516,8040,"reading"
"6211",25,2,41,37,12091213,12095166,3953,"reading"
"6416",25,2,59,38,12099565,12104350,4785,"reading"
"6517",25,2,52,39,12106206,12110100,3894,"reading"
"6617",25,2,56,40,12111772,12116517,4745,"reading"
"6716",25,3,77,41,12118472,12121550,3078,"reading"
"6818",25,3,71,42,12262372,12265539,3167,"reading"
"7020",25,2,53,43,12270193,12273572,3379,"reading"
"7117",25,3,76,44,12275330,12278989,3659,"reading"
"7215",25,3,61,45,12280719,12285423,4704,"reading"
"7418",25,2,60,46,12290489,12293790,3301,"reading"
"7517",25,3,90,47,12296106,12301856,5750,"reading"
"7620",25,2,49,48,12303549,12309574,6025,"reading"
"7715",25,3,62,49,12311246,12313923,2677,"reading"
"7921",25,2,58,50,12318561,12321457,2896,"reading"
"8016",25,3,78,51,12324077,12329374,5297,"reading"
"8116",25,3,73,52,12331058,12334341,3283,"reading"
"8217",25,2,55,53,12336394,12339691,3297,"reading"
"8318",25,3,82,54,12341441,12349625,8184,"reading"
"8419",25,3,83,55,12351218,12354042,2824,"reading"
"8515",25,2,54,56,12355771,12358926,3155,"reading"
"8615",25,3,70,57,12360490,12366425,5935,"reading"
"8817",25,2,37,58,12371726,12374326,2600,"reading"
"9019",25,3,87,59,12379906,12385176,5270,"reading"
"9120",25,3,68,60,12387182,12391110,3928,"reading"
"9315",25,3,88,61,12396096,12399577,3481,"reading"
"9418",25,2,42,62,12401879,12410093,8214,"reading"
"9620",25,2,36,63,12415339,12418911,3572,"reading"
"9818",25,3,85,64,12423142,12429261,6119,"reading"
"9918",25,3,65,65,12431005,12438911,7906,"reading"
"10122",25,3,72,66,12444584,12447428,2844,"reading"
"10317",25,3,84,67,12453133,12458112,4979,"reading"
"10420",25,2,40,68,12459692,12464329,4637,"reading"
"10620",25,3,69,69,12469958,12475246,5288,"reading"
"10818",25,2,48,70,12480359,12486596,6237,"reading"
"10914",25,2,45,71,12488280,12493930,5650,"reading"
"11018",25,3,89,72,12495771,12498297,2526,"reading"
"11118",25,2,47,73,12500101,12504513,4412,"reading"
"11214",25,3,63,74,12506417,12509547,3130,"reading"
"11416",25,3,67,75,12514546,12520664,6118,"reading"
"11621",25,2,43,76,12525128,12532648,7520,"reading"
"11716",25,2,39,77,12535592,12540281,4689,"reading"
"11917",25,3,64,78,12546485,12550815,4330,"reading"
"12120",25,2,50,79,12556728,12560915,4187,"reading"
"12217",25,3,79,80,12562940,12569299,6359,"reading"
"12319",25,3,81,81,12571340,12576399,5059,"reading"
"12415",25,2,38,82,12578341,12581983,3642,"reading"
"12616",25,3,75,83,12586654,12592900,6246,"reading"
"12719",25,2,51,84,12594912,12598417,3505,"reading"
"12818",25,2,46,85,12600995,12604767,3772,"reading"
"12915",25,3,80,86,12606953,12609867,2914,"reading"
"13018",25,2,35,87,12611987,12615901,3914,"reading"
"13218",25,3,86,88,12620784,12624834,4050,"reading"
"13320",25,2,34,89,12626969,12631435,4466,"reading"
"13518",25,2,44,90,12636113,12642468,6355,"reading"
"14520",25,1,98,91,12854345,12857492,3147,"zString"
"14719",25,1,110,92,12861474,12864659,3185,"zString"
"1488",25,1,118,93,12880064,12883110,3046,"zString"
"14921",25,1,105,94,12885766,12888077,2311,"zString"
"1508",25,1,115,95,12889725,12892427,2702,"zString"
"15122",25,1,99,96,12894955,12898577,3622,"zString"
"15317",25,1,101,97,12903344,12905810,2466,"zString"
"15521",25,1,100,98,12910389,12913394,3005,"zString"
"15718",25,1,112,99,12917649,12920528,2879,"zString"
"15815",25,1,97,100,12922678,12925845,3167,"zString"
"16016",25,1,108,101,12930103,12934228,4125,"zString"
"16125",25,1,107,102,12935877,12939412,3535,"zString"
"16219",25,1,109,103,12940977,12944945,3968,"zString"
"16318",25,1,104,104,12947637,12951479,3842,"zString"
"16419",25,1,106,105,12953074,12956462,3388,"zString"
"16516",25,1,93,106,12958463,12960529,2066,"zString"
"16718",25,1,114,107,12964821,12967713,2892,"zString"
"16818",25,1,92,108,12969450,12973046,3596,"zString"
"17018",25,1,120,109,12976925,12980547,3622,"zString"
"17120",25,1,119,110,12982198,12985113,2915,"zString"
"17219",25,1,111,111,12987282,12989780,2498,"zString"
"17315",25,1,91,112,12991948,12996147,4199,"zString"
"17518",25,1,94,113,13000036,13003214,3178,"zString"
"17717",25,1,95,114,13008020,13015698,7678,"zString"
"17919",25,1,117,115,13019383,13021514,2131,"zString"
"18019",25,1,102,116,13023374,13025131,1757,"zString"
"18220",25,1,116,117,13029079,13032481,3402,"zString"
"18313",25,1,113,118,13034130,13036832,2702,"zString"
"18419",25,1,103,119,13039118,13042098,2980,"zString"
"18516",25,1,96,120,13044181,13047016,2835,"zString"
"18721",25,2,121,121,13052466,13055299,2833,"zString"
"18920",25,2,122,122,13059526,13062016,2490,"zString"
"19121",25,2,123,123,13066566,13069033,2467,"zString"
"19318",25,2,137,124,13073601,13076049,2448,"zString"
"19419",25,3,168,125,13077455,13081783,4328,"zString"
"19517",25,2,126,126,13083556,13086450,2894,"zString"
"19719",25,3,178,127,13090873,13095816,4943,"zString"
"19817",25,2,128,128,13098242,13103601,5359,"zString"
"20019",25,3,159,129,13107850,13110201,2351,"zString"
"20215",25,3,151,130,13114297,13117435,3138,"zString"
"20417",25,3,165,131,13121623,13125168,3545,"zString"
"20518",25,2,127,132,13204114,13208854,4740,"zString"
"20721",25,3,160,133,13213175,13216755,3580,"zString"
"20921",25,2,133,134,13221789,13224288,2499,"zString"
"21017",25,3,152,135,13226230,13230038,3808,"zString"
"21218",25,3,172,136,13234505,13239056,4551,"zString"
"21316",25,3,156,137,13241271,13247456,6185,"zString"
"21518",25,2,130,138,13251909,13254473,2564,"zString"
"21721",25,2,138,139,13259040,13262156,3116,"zString"
"21817",25,2,124,140,13264721,13268090,3369,"zString"
"22016",25,2,143,141,13274286,13277474,3188,"zString"
"22124",25,2,142,142,13279498,13282757,3259,"zString"
"22218",25,2,131,143,13284934,13288224,3290,"zString"
"22419",25,3,177,144,13326637,13329659,3022,"zString"
"22518",25,3,164,145,13332930,13336342,3412,"zString"
"22615",25,3,154,146,13338547,13341592,3045,"zString"
"22819",25,3,153,147,13346032,13348942,2910,"zString"
"23018",25,3,173,148,13355258,13357960,2702,"zString"
"23119",25,3,161,149,13360675,13362976,2301,"zString"
"23320",25,3,155,150,13367751,13370594,2843,"zString"
"23517",25,3,176,151,13375653,13379144,3491,"zString"
"23617",25,2,136,152,13383324,13389694,6370,"zString"
"23717",25,2,135,153,13395504,13402311,6807,"zString"
"23818",25,3,158,154,13405911,13410211,4300,"zString"
"24016",25,3,166,155,13415271,13418195,2924,"zString"
"24119",25,3,174,156,13422181,13427628,5447,"zString"
"24219",25,2,146,157,13430934,13433862,2928,"zString"
"24317",25,3,179,158,13436809,13439712,2903,"zString"
"24419",25,2,134,159,13442273,13445996,3723,"zString"
"24520",25,2,149,160,13448079,13450963,2884,"zString"
"24617",25,2,141,161,13456044,13460030,3986,"zString"
"24716",25,3,157,162,13462410,13466813,4403,"zString"
"24918",25,3,169,163,13471589,13475214,3625,"zString"
"25016",25,3,175,164,13478675,13483764,5089,"zString"
"25121",25,3,180,165,13486175,13489897,3722,"zString"
"25218",25,2,125,166,13493565,13496914,3349,"zString"
"25415",25,2,132,167,13503650,13506764,3114,"zString"
"25616",25,2,129,168,13512204,13517198,4994,"zString"
"25816",25,2,148,169,13524784,13528715,3931,"zString"
"25915",25,2,150,170,13531104,13534149,3045,"zString"
"26022",25,2,147,171,13541578,13545116,3538,"zString"
"26120",25,3,162,172,13549179,13553733,4554,"zString"
"26318",25,3,170,173,13558391,13561600,3209,"zString"
"26416",25,2,139,174,13564563,13567133,2570,"zString"
"26517",25,2,145,175,13569360,13572450,3090,"zString"
"26617",25,3,167,176,13576792,13582167,5375,"zString"
"26717",25,3,163,177,13586353,13592034,5681,"zString"
"26820",25,2,144,178,13596288,13599584,3296,"zString"
"26916",25,3,171,179,13602073,13607185,5112,"zString"
"27020",25,2,140,180,13609199,13614451,5252,"zString"
"10105",26,1,73,1,630600,634766,4166,"zString"
"1140",26,1,72,2,636433,641966,5533,"zString"
"1350",26,1,82,3,653946,658933,4987,"zString"
"1427",26,1,79,4,661503,665801,4298,"zString"
"1560",26,1,63,5,667592,673934,6342,"zString"
"17100",26,1,71,6,696246,705752,9506,"zString"
"19100",26,1,88,7,710463,715969,5506,"zString"
"2060",26,1,74,8,717813,723236,5423,"zString"
"21103",26,1,83,9,724985,731853,6868,"zString"
"22104",26,1,70,10,733617,739620,6003,"zString"
"2490",26,1,84,11,748587,755520,6933,"zString"
"25104",26,1,68,12,757209,766637,9428,"zString"
"2727",26,1,89,13,773636,778188,4552,"zString"
"2815",26,1,87,14,779817,784671,4854,"zString"
"2919",26,1,75,15,786560,794138,7578,"zString"
"3020",26,1,66,16,795775,803922,8147,"zString"
"3221",26,1,62,17,809242,816622,7380,"zString"
"3415",26,1,90,18,820748,825673,4925,"zString"
"3519",26,1,80,19,827416,835073,7657,"zString"
"3616",26,1,65,20,836828,843973,7145,"zString"
"3816",26,1,78,21,849639,862241,12602,"zString"
"3920",26,1,77,22,864337,870725,6388,"zString"
"4019",26,1,67,23,872610,876825,4215,"zString"
"4216",26,1,86,24,883125,888041,4916,"zString"
"4321",26,1,76,25,889991,897259,7268,"zString"
"4418",26,1,61,26,899280,902575,3295,"zString"
"4616",26,1,64,27,908174,917059,8885,"zString"
"4818",26,1,81,28,922012,926760,4748,"zString"
"4921",26,1,85,29,928446,935960,7514,"zString"
"5016",26,1,69,30,937897,943977,6080,"zString"
"5221",26,2,1,31,947847,954561,6714,"zString"
"5417",26,2,2,32,961670,966011,4341,"zString"
"5619",26,2,3,33,970379,973245,2866,"zString"
"5817",26,2,15,34,977310,982178,4868,"zString"
"5919",26,3,51,35,984282,990479,6197,"zString"
"6020",26,3,42,36,992833,999912,7079,"zString"
"6212",26,2,23,37,1005260,1011496,6236,"zString"
"6321",26,2,17,38,1013239,1016096,2857,"zString"
"6417",26,2,7,39,1018208,1023213,5005,"zString"
"6618",26,2,22,40,1028103,1032313,4210,"zString"
"6717",26,3,46,41,1034702,1038913,4211,"zString"
"6819",26,3,47,42,1228049,1235288,7239,"zString"
"6917",26,2,11,43,1237905,1243655,5750,"zString"
"7118",26,2,5,44,1274787,1281323,6536,"zString"
"7320",26,3,55,45,1285358,1292006,6648,"zString"
"7419",26,3,38,46,1293967,1300540,6573,"zString"
"7621",26,3,43,47,1304385,1311657,7272,"zString"
"7716",26,3,60,48,1313177,1322409,9232,"zString"
"7814",26,2,19,49,1324817,1331441,6624,"zString"
"7922",26,3,49,50,1333874,1337974,4100,"zString"
"8017",26,3,54,51,1339470,1342725,3255,"zString"
"8117",26,3,50,52,1344468,1348408,3940,"zString"
"8218",26,2,27,53,1350606,1354827,4221,"zString"
"8319",26,2,26,54,1356518,1361425,4907,"zString"
"8420",26,3,53,55,1363360,1367542,4182,"zString"
"8516",26,2,24,56,1369382,1373726,4344,"zString"
"8616",26,3,58,57,1375626,1380426,4800,"zString"
"8715",26,2,10,58,1382330,1384860,2530,"zString"
"8919",26,3,52,59,1393146,1402344,9198,"zString"
"9020",26,2,25,60,1404159,1405560,1401,"zString"
"9121",26,2,9,61,1407387,1411194,3807,"zString"
"9316",26,2,16,62,1415900,1422494,6594,"zString"
"9419",26,2,14,63,1424322,1427394,3072,"zString"
"9520",26,3,39,64,1429284,1433129,3845,"zString"
"9716",26,2,12,65,1438091,1442328,4237,"zString"
"9919",26,2,18,66,1447175,1453346,6171,"zString"
"10018",26,2,8,67,1454915,1459595,4680,"zString"
"10223",26,3,48,68,1464032,1473846,9814,"zString"
"10318",26,3,37,69,1475812,1477962,2150,"zString"
"10517",26,3,35,70,1484570,1488630,4060,"zString"
"10717",26,3,41,71,1497780,1506197,8417,"zString"
"10915",26,3,32,72,1510201,1520731,10530,"zString"
"11119",26,3,31,73,1527980,1535281,7301,"zString"
"11321",26,3,33,74,1539034,1545682,6648,"zString"
"11514",26,3,45,75,1549709,1556382,6673,"zString"
"11622",26,3,34,76,1557918,1568549,10631,"zString"
"11814",26,3,57,77,1572955,1584917,11962,"zString"
"11918",26,3,59,78,1587454,1595617,8163,"zString"
"12020",26,3,44,79,1598008,1609351,11343,"zString"
"12121",26,2,28,80,1611280,1619618,8338,"zString"
"12218",26,3,36,81,1621330,1630302,8972,"zString"
"12416",26,2,6,82,1635678,1648402,12724,"zString"
"12617",26,2,13,83,1654917,1662536,7619,"zString"
"12720",26,2,20,84,1665131,1673937,8806,"zString"
"12819",26,3,40,85,1675869,1686586,10717,"zString"
"13019",26,3,56,86,1692863,1709888,17025,"zString"
"13116",26,2,4,87,1711894,1723955,12061,"zString"
"13321",26,2,21,88,1729184,1738705,9521,"zString"
"13415",26,2,30,89,1741183,1750439,9256,"zString"
"13519",26,2,29,90,1752794,1757555,4761,"zString"
"14521",26,1,159,91,2002115,2011264,9149,"reading"
"14720",26,1,179,92,2016169,2021832,5663,"reading"
"1489",26,1,153,93,2023485,2029017,5532,"reading"
"1509",26,1,175,94,2033248,2037916,4668,"reading"
"15123",26,1,160,95,2039519,2045099,5580,"reading"
"15318",26,1,166,96,2050238,2056333,6095,"reading"
"15417",26,1,170,97,2058536,2063916,5380,"reading"
"15522",26,1,176,98,2065752,2074268,8516,"reading"
"15617",26,1,177,99,2076313,2084167,7854,"reading"
"15719",26,1,154,100,2085861,2092317,6456,"reading"
"15918",26,1,172,101,2098186,2102401,4215,"reading"
"16017",26,1,152,102,2104071,2110201,6130,"reading"
"16220",26,1,174,103,2116694,2123018,6324,"reading"
"16319",26,1,165,104,2125045,2132185,7140,"reading"
"16420",26,1,158,105,2133789,2139902,6113,"reading"
"16617",26,1,178,106,2147268,2154103,6835,"reading"
"16719",26,1,162,107,2156156,2161420,5264,"reading"
"16917",26,1,155,108,2166542,2174187,7645,"reading"
"17121",26,1,156,109,2185308,2189237,3929,"reading"
"17316",26,1,161,110,2195499,2201437,5938,"reading"
"17519",26,1,167,111,2209035,2217888,8853,"reading"
"17617",26,1,164,112,2219744,2227639,7895,"reading"
"17718",26,1,173,113,2229175,2235139,5964,"reading"
"17814",26,1,168,114,2237015,2245306,8291,"reading"
"17920",26,1,157,115,2246965,2253273,6308,"reading"
"18118",26,1,180,116,2258364,2264756,6392,"reading"
"18221",26,1,171,117,2268856,2273224,4368,"reading"
"18314",26,1,163,118,2275699,2283640,7941,"reading"
"18420",26,1,151,119,2285527,2290757,5230,"reading"
"18615",26,1,169,120,2296284,2304475,8191,"reading"
"18722",26,2,91,121,2306408,2313041,6633,"reading"
"18921",26,2,92,122,2321779,2329242,7463,"reading"
"19122",26,2,93,123,2334215,2339226,5011,"reading"
"19319",26,3,148,124,2343497,2349643,6146,"reading"
"19420",26,2,115,125,2352279,2355727,3448,"reading"
"19518",26,3,132,126,2357346,2361110,3764,"reading"
"19720",26,3,141,127,2365768,2372327,6559,"reading"
"19818",26,3,144,128,2374664,2379827,5163,"reading"
"19915",26,3,127,129,2384774,2389944,5170,"reading"
"20124",26,3,143,130,2395359,2402145,6786,"reading"
"20216",26,3,147,131,2432074,2437446,5372,"reading"
"20318",26,2,94,132,2600260,2605052,4792,"reading"
"20519",26,3,134,133,2609757,2614452,4695,"reading"
"20617",26,3,126,134,2616397,2619736,3339,"reading"
"20816",26,3,121,135,2624855,2629736,4881,"reading"
"21018",26,3,125,136,2634330,2638819,4489,"reading"
"21219",26,2,103,137,2643339,2648637,5298,"reading"
"21317",26,3,128,138,2650452,2658004,7552,"reading"
"21519",26,2,100,139,2666995,2673037,6042,"reading"
"21722",26,2,107,140,2677660,2681704,4044,"reading"
"21818",26,2,118,141,2684725,2691938,7213,"reading"
"21918",26,2,108,142,2693733,2700455,6722,"reading"
"22017",26,2,96,143,2716411,2722507,6096,"reading"
"22219",26,2,117,144,2727276,2732057,4781,"reading"
"22319",26,3,133,145,2734002,2738091,4089,"reading"
"22420",26,3,124,146,2739613,2746224,6611,"reading"
"22616",26,2,95,147,2750835,2755191,4356,"reading"
"22820",26,3,122,148,2759376,2764725,5349,"reading"
"23019",26,3,135,149,2768989,2774059,5070,"reading"
"23120",26,2,105,150,2776294,2779825,3531,"reading"
"23219",26,3,138,151,2781430,2785092,3662,"reading"
"23321",26,2,109,152,2787388,2790809,3421,"reading"
"23418",26,2,104,153,2793095,2798460,5365,"reading"
"23518",26,2,116,154,2800269,2805926,5657,"reading"
"23618",26,3,139,155,2807779,2812460,4681,"reading"
"23718",26,3,137,156,2814241,2819677,5436,"reading"
"23819",26,2,99,157,2821723,2826060,4337,"reading"
"24017",26,2,111,158,2831809,2836577,4768,"reading"
"24120",26,2,119,159,2838186,2843677,5491,"reading"
"24220",26,2,101,160,2846430,2850395,3965,"reading"
"24420",26,3,142,161,2856843,2862478,5635,"reading"
"24521",26,3,129,162,2864508,2869895,5387,"reading"
"24717",26,3,130,163,2875115,2881213,6098,"reading"
"24919",26,3,123,164,2885713,2889145,3432,"reading"
"25122",26,2,114,165,2893215,2898179,4964,"reading"
"25219",26,2,97,166,2899782,2904496,4714,"reading"
"25416",26,2,98,167,2908684,2913830,5146,"reading"
"25617",26,2,106,168,2918400,2923814,5414,"reading"
"25720",26,3,140,169,2925616,2930630,5014,"reading"
"25817",26,2,120,170,2932267,2938381,6114,"reading"
"25916",26,3,146,171,2939850,2944200,4350,"reading"
"26023",26,3,145,172,2945984,2951715,5731,"reading"
"26121",26,2,110,173,2953952,2958698,4746,"reading"
"26217",26,2,102,174,2960301,2965032,4731,"reading"
"26417",26,3,150,175,2970201,2977865,7664,"reading"
"26518",26,3,131,176,2981037,2986165,5128,"reading"
"26718",26,2,112,177,2991287,2997349,6062,"reading"
"26821",26,3,149,178,2999758,3007233,7475,"reading"
"26917",26,3,136,179,3009286,3014483,5197,"reading"
"27021",26,2,113,180,3016863,3022167,5304,"reading"
"10106",27,2,61,1,1179849,1189161,9312,"reading"
"12102",27,2,62,2,1197887,1206094,8207,"reading"
"1428",27,2,63,3,1211238,1217428,6190,"reading"
"17101",27,2,69,5,1244891,1250512,5621,"reading"
"19101",27,2,73,6,1262100,1267779,5679,"reading"
"2070",27,2,75,7,1269753,1276496,6743,"reading"
"21104",27,2,66,8,1280893,1287130,6237,"reading"
"23105",27,2,68,9,1293007,1301814,8807,"reading"
"25105",27,3,11,10,1312124,1321931,9807,"reading"
"2728",27,2,82,11,1328806,1338298,9492,"reading"
"2816",27,3,10,12,1340803,1346933,6130,"reading"
"3021",27,3,1,13,1351756,1359633,7877,"reading"
"3222",27,3,17,14,1364974,1373367,8393,"reading"
"3317",27,2,83,15,1375890,1380483,4593,"reading"
"3416",27,3,12,16,1382778,1389417,6639,"reading"
"3617",27,3,9,17,1394292,1398984,4692,"reading"
"3817",27,2,71,18,1404118,1408968,4850,"reading"
"4020",27,3,27,19,1414145,1423069,8924,"reading"
"4121",27,2,90,20,1425049,1430652,5603,"reading"
"4217",27,2,72,21,1433612,1440052,6440,"reading"
"4419",27,2,85,22,1445059,1450886,5827,"reading"
"4519",27,3,28,23,1452892,1458486,5594,"reading"
"4617",27,2,76,24,1460458,1465420,4962,"reading"
"4718",27,3,2,25,1467250,1473653,6403,"reading"
"4922",27,2,84,26,1478405,1485087,6682,"reading"
"5017",27,2,77,27,1486906,1494371,7465,"reading"
"5116",27,3,8,28,1496683,1505405,8722,"reading"
"5311",27,3,30,29,1513499,1519805,6306,"reading"
"5418",27,3,15,30,1521792,1529255,7463,"reading"
"559",27,3,26,31,1531263,1536889,5626,"reading"
"5620",27,3,24,32,1538683,1546506,7823,"reading"
"5712",27,3,29,33,1548334,1553906,5572,"reading"
"5818",27,2,81,34,1555891,1563990,8099,"reading"
"5920",27,3,19,35,1565979,1571607,5628,"reading"
"6021",27,2,65,36,1573490,1580274,6784,"reading"
"6213",27,2,74,37,1585917,1593057,7140,"reading"
"6322",27,2,64,38,1595856,1601424,5568,"reading"
"6518",27,2,88,39,1606417,1612791,6374,"reading"
"6619",27,2,78,40,1614533,1619392,4859,"reading"
"6718",27,3,4,41,1621359,1627875,6516,"reading"
"6918",27,2,70,42,1633360,1640192,6832,"reading"
"7119",27,2,79,43,1695665,1702728,7063,"reading"
"7216",27,2,89,44,1704993,1712162,7169,"reading"
"7321",27,2,87,45,1715817,1721628,5811,"reading"
"7420",27,3,25,46,1723691,1728478,4787,"reading"
"7518",27,3,5,47,1730405,1736429,6024,"reading"
"7717",27,3,14,48,1742689,1749563,6874,"reading"
"7815",27,3,6,49,1751554,1758147,6593,"reading"
"8018",27,3,18,50,1764030,1772413,8383,"reading"
"8118",27,3,7,51,1774927,1780280,5353,"reading"
"8320",27,2,67,52,1836731,1840419,3688,"reading"
"8517",27,3,21,53,1850888,1859836,8948,"reading"
"8617",27,3,16,54,1861684,1869920,8236,"reading"
"8716",27,2,86,55,1873730,1882587,8857,"reading"
"8818",27,3,13,56,1884753,1890254,5501,"reading"
"8920",27,2,80,57,1898891,1904654,5763,"reading"
"9021",27,3,22,58,1906947,1912705,5758,"reading"
"9122",27,3,3,59,1917354,1923438,6084,"reading"
"9317",27,3,20,60,1928715,1933656,4941,"reading"
"9420",27,3,23,61,1935692,1941322,5630,"reading"
"9521",27,1,39,62,1943635,1949073,5438,"reading"
"9717",27,1,43,63,1954164,1961290,7126,"reading"
"9819",27,1,37,64,1963399,1968290,4891,"reading"
"10019",27,1,46,65,1983930,1992157,8227,"reading"
"10123",27,1,54,66,1994640,2003324,8684,"reading"
"10224",27,1,40,67,2005310,2009608,4298,"reading"
"10421",27,1,48,68,2015474,2024026,8552,"reading"
"10518",27,1,45,69,2026046,2034709,8663,"reading"
"10621",27,1,32,70,2036839,2040159,3320,"reading"
"10819",27,1,60,71,2045736,2049976,4240,"reading"
"10916",27,1,47,72,2051917,2060610,8693,"reading"
"11019",27,1,52,73,2062582,2072293,9711,"reading"
"11120",27,1,41,74,2074340,2079110,4770,"reading"
"11322",27,1,55,75,2084487,2089461,4974,"reading"
"11417",27,1,31,76,2091566,2097144,5578,"reading"
"11623",27,1,57,77,2104635,2110195,5560,"reading"
"11717",27,1,53,78,2112080,2117962,5882,"reading"
"11815",27,1,33,79,2119697,2125095,5398,"reading"
"12021",27,1,58,80,2130224,2138779,8555,"reading"
"12122",27,1,42,81,2142992,2152146,9154,"reading"
"12320",27,1,56,82,2157201,2161714,4513,"reading"
"12417",27,1,36,83,2163850,2169764,5914,"reading"
"12618",27,1,51,84,2174788,2180497,5709,"reading"
"12721",27,1,59,85,2185025,2188481,3456,"reading"
"12820",27,1,35,86,2190742,2194531,3789,"reading"
"13020",27,1,34,87,2199464,2204048,4584,"reading"
"13219",27,1,49,88,2215627,2223815,8188,"reading"
"13322",27,1,50,89,2226270,2232799,6529,"reading"
"13416",27,1,38,90,2234637,2240299,5662,"reading"
"1364",27,1,44,91,2246095,2249800,3705,"reading"
"1467",27,2,151,92,2508909,2519944,11035,"zString"
"14810",27,2,152,93,2559788,2573746,13958,"zString"
"15010",27,2,153,94,2578322,2584796,6474,"zString"
"15218",27,3,100,95,2588956,2597330,8374,"zString"
"15418",27,2,171,96,2601458,2610481,9023,"zString"
"15523",27,3,95,97,2612437,2619297,6860,"zString"
"15720",27,2,155,98,2623386,2630381,6995,"zString"
"15919",27,2,175,99,2635284,2642448,7164,"zString"
"16018",27,3,99,100,2644694,2654548,9854,"zString"
"16221",27,2,156,101,2659197,2667965,8768,"zString"
"16421",27,3,101,102,2671597,2677716,6119,"zString"
"16618",27,2,167,103,2681744,2692216,10472,"zString"
"16720",27,3,114,104,2694409,2701983,7574,"zString"
"16819",27,3,92,105,2704149,2712034,7885,"zString"
"17019",27,3,115,106,2716514,2722134,5620,"zString"
"17122",27,2,180,107,2724066,2730134,6068,"zString"
"17220",27,3,97,108,2732327,2738702,6375,"zString"
"17419",27,2,177,109,2743253,2753985,10732,"zString"
"17520",27,3,94,110,2756560,2762419,5859,"zString"
"17719",27,3,104,111,2766412,2771920,5508,"zString"
"17815",27,3,93,112,2773689,2780519,6830,"zString"
"18020",27,3,119,113,2784418,2795020,10602,"zString"
"18119",27,3,113,114,2796944,2804054,7110,"zString"
"18222",27,3,105,115,2806203,2814087,7884,"zString"
"18315",27,2,159,116,2816090,2824638,8548,"zString"
"18517",27,2,162,117,2828646,2836954,8308,"zString"
"18723",27,3,102,118,2841421,2850039,8618,"zString"
"18922",27,2,179,119,2853856,2862322,8466,"zString"
"19012",27,2,160,120,2864302,2874123,9821,"zString"
"19215",27,2,163,121,2878067,2886140,8073,"zString"
"19320",27,3,117,122,2888203,2892840,4637,"zString"
"19421",27,3,103,123,2894991,2902107,7116,"zString"
"19519",27,3,107,124,2905791,2911807,6016,"zString"
"19617",27,2,178,125,2915413,2922941,7528,"zString"
"19721",27,2,161,126,2925625,2934741,9116,"zString"
"19916",27,2,173,127,2939196,2945042,5846,"zString"
"20020",27,3,108,128,2947395,2951542,4147,"zString"
"20125",27,3,110,129,2953484,2958559,5075,"zString"
"20217",27,3,91,130,2960833,2969959,9126,"zString"
"20418",27,3,98,131,2975690,2981676,5986,"zString"
"20618",27,3,116,132,2985750,2991394,5644,"zString"
"20722",27,2,172,133,3115091,3124214,9123,"zString"
"20817",27,2,168,134,3140619,3146132,5513,"zString"
"20922",27,2,165,135,3148054,3153899,5845,"zString"
"21019",27,2,169,136,3156363,3163249,6886,"zString"
"21122",27,2,176,137,3165746,3170633,4887,"zString"
"21220",27,3,106,138,3172822,3180200,7378,"zString"
"21318",27,2,174,139,3182117,3188967,6850,"zString"
"21417",27,3,120,140,3190983,3197167,6184,"zString"
"21520",27,2,164,141,3199843,3208734,8891,"zString"
"21616",27,2,158,142,3210937,3216351,5414,"zString"
"21819",27,2,157,143,3220796,3228535,7739,"zString"
"22018",27,2,170,144,3232541,3240035,7494,"zString"
"22125",27,3,118,145,3242094,3248669,6575,"zString"
"22220",27,3,112,146,3250431,3259303,8872,"zString"
"22320",27,2,166,147,3263438,3272470,9032,"zString"
"22421",27,3,96,148,3274836,3281086,6250,"zString"
"22617",27,2,154,149,3289737,3295354,5617,"zString"
"22821",27,3,111,150,3299502,3305571,6069,"zString"
"22917",27,3,109,151,3307534,3311654,4120,"zString"
"23020",27,1,139,152,3313549,3317571,4022,"zString"
"23121",27,1,122,153,3319547,3325205,5658,"zString"
"23322",27,1,140,154,3329675,3334155,4480,"zString"
"23419",27,1,130,155,3336409,3344672,8263,"zString"
"23619",27,1,150,156,3348616,3358673,10057,"zString"
"23719",27,1,137,157,3360540,3366073,5533,"zString"
"23820",27,1,129,158,3368085,3377490,9405,"zString"
"24018",27,1,138,159,3381827,3387057,5230,"zString"
"24121",27,1,128,160,3389486,3394157,4671,"zString"
"24318",27,1,135,161,3398384,3406041,7657,"zString"
"24421",27,1,126,162,3408343,3416058,7715,"zString"
"24618",27,1,124,163,3420274,3426692,6418,"zString"
"24816",27,1,125,164,3430686,3435408,4722,"zString"
"25017",27,1,121,165,3440574,3444626,4052,"zString"
"25220",27,1,149,166,3448869,3457943,9074,"zString"
"25318",27,1,123,167,3460315,3466643,6328,"zString"
"25518",27,1,146,168,3471092,3477027,5935,"zString"
"25618",27,1,142,169,3479068,3484210,5142,"zString"
"25721",27,1,136,170,3486487,3491961,5474,"zString"
"25818",27,1,145,171,3493968,3500128,6160,"zString"
"25917",27,1,133,172,3501985,3512529,10544,"zString"
"26024",27,1,141,173,3514601,3519328,4727,"zString"
"26122",27,1,143,174,3521354,3529712,8358,"zString"
"26218",27,1,148,175,3531882,3540379,8497,"zString"
"26319",27,1,134,176,3543315,3553362,10047,"zString"
"26418",27,1,131,177,3555636,3562329,6693,"zString"
"26618",27,1,132,178,3566095,3571597,5502,"zString"
"26822",27,1,127,179,3575974,3581313,5339,"zString"
"27022",27,1,147,180,3585053,3590997,5944,"zString"
"27110",27,1,144,181,3592632,3599248,6616,"zString"
"10107",28,2,31,1,4758068,4763561,5493,"zString"
"12103",28,2,32,2,4768014,4772645,4631,"zString"
"1429",28,2,33,3,4777517,4781662,4145,"zString"
"16101",28,2,34,4,4786323,4790578,4255,"zString"
"18101",28,3,67,5,4795131,4799512,4381,"zString"
"2080",28,2,35,6,4804217,4808562,4345,"zString"
"22105",28,3,86,7,4813960,4818580,4620,"zString"
"23106",28,3,61,8,4821788,4825880,4092,"zString"
"25106",28,2,43,9,4830731,4835480,4749,"zString"
"2690",28,3,69,10,4837693,4841847,4154,"zString"
"2817",28,3,88,11,4846534,4851414,4880,"zString"
"2920",28,2,51,12,4854039,4859464,5425,"zString"
"3022",28,2,38,13,4862099,4868064,5965,"zString"
"3223",28,3,82,14,4872586,4876898,4312,"zString"
"3318",28,2,42,15,4879102,4882982,3880,"zString"
"3520",28,3,74,16,4891036,4895515,4479,"zString"
"3618",28,2,56,17,4898856,4902832,3976,"zString"
"3722",28,3,87,18,4905676,4909532,3856,"zString"
"3818",28,2,39,19,4912488,4916766,4278,"zString"
"4021",28,3,71,20,4921749,4925683,3934,"zString"
"4218",28,3,81,21,4930778,4934383,3605,"zString"
"4322",28,2,59,22,4936805,4940834,4029,"zString"
"4420",28,2,49,23,4943461,4947417,3956,"zString"
"4520",28,2,40,24,4949919,4954567,4648,"zString"
"4719",28,2,41,25,4959087,4963301,4214,"zString"
"4923",28,3,65,26,4967777,4971718,3941,"zString"
"5117",28,3,75,27,4976803,4980918,4115,"zString"
"5222",28,2,54,28,4983393,4988002,4609,"zString"
"5312",28,2,45,29,4990250,4993985,3735,"zString"
"5419",28,2,46,30,4996453,5000319,3866,"zString"
"5510",28,3,68,31,5003371,5008669,5298,"zString"
"5713",28,2,36,32,5013385,5018303,4918,"zString"
"5921",28,2,47,33,5022911,5027853,4942,"zString"
"6022",28,3,70,34,5030107,5033953,3846,"zString"
"6214",28,2,57,35,5038863,5042870,4007,"zString"
"6323",28,2,52,36,5045430,5049838,4408,"zString"
"6418",28,2,48,37,5052131,5057004,4873,"zString"
"6519",28,3,63,38,5059307,5063821,4514,"zString"
"6719",28,3,85,39,5068545,5072471,3926,"zString"
"6820",28,3,73,40,5074677,5078005,3328,"zString"
"6919",28,2,44,41,5080133,5083989,3856,"zString"
"7021",28,2,58,42,5151492,5156058,4566,"zString"
"7120",28,3,84,43,5158513,5162975,4462,"zString"
"7217",28,3,66,44,5165640,5168641,3001,"zString"
"7421",28,3,79,45,5172967,5177775,4808,"zString"
"7519",28,3,62,46,5179851,5184075,4224,"zString"
"7718",28,3,77,47,5188265,5192192,3927,"zString"
"7816",28,3,80,48,5194479,5199726,5247,"zString"
"7923",28,3,83,49,5201644,5206709,5065,"zString"
"8019",28,2,37,50,5208786,5212593,3807,"zString"
"8219",28,2,55,51,5216819,5221443,4624,"zString"
"8321",28,3,89,52,5226212,5231060,4848,"zString"
"8421",28,2,50,53,5234184,5238760,4576,"zString"
"8518",28,2,53,54,5241168,5245561,4393,"zString"
"8618",28,2,60,55,5247737,5251894,4157,"zString"
"8717",28,3,78,56,5254042,5258361,4319,"zString"
"8819",28,3,90,57,5260553,5264278,3725,"zString"
"8921",28,3,76,58,5267231,5271995,4764,"zString"
"9022",28,3,64,59,5274610,5280095,5485,"zString"
"9217",28,3,72,60,5286502,5292712,6210,"zString"
"9421",28,1,21,61,5297694,5301529,3835,"zString"
"9522",28,1,8,62,5303598,5308263,4665,"zString"
"9718",28,1,3,63,5312997,5317463,4466,"zString"
"9920",28,1,12,64,5322358,5326080,3722,"zString"
"10124",28,1,4,65,5330752,5334947,4195,"zString"
"10319",28,1,20,66,5339045,5342997,3952,"zString"
"10422",28,1,22,67,5344933,5349448,4515,"zString"
"10519",28,1,15,68,5351582,5356048,4466,"zString"
"10622",28,1,24,69,5357875,5362165,4290,"zString"
"10718",28,1,17,70,5363961,5368065,4104,"zString"
"10820",28,1,26,71,5370190,5374448,4258,"zString"
"10917",28,1,11,72,5377218,5381532,4314,"zString"
"11121",28,1,7,73,5385939,5390349,4410,"zString"
"11323",28,1,1,74,5395114,5398516,3402,"zString"
"11515",28,1,5,75,5403062,5406566,3504,"zString"
"11718",28,1,18,76,5411282,5415400,4118,"zString"
"11816",28,1,14,77,5417682,5421467,3785,"zString"
"11919",28,1,30,78,5423315,5427201,3886,"zString"
"12022",28,1,13,79,5429256,5432734,3478,"zString"
"12123",28,1,10,80,5434771,5438067,3296,"zString"
"12418",28,1,6,82,5500531,5505105,4574,"zString"
"12619",28,1,28,83,5509776,5514456,4680,"zString"
"12722",28,1,27,84,5516350,5520690,4340,"zString"
"12821",28,1,2,85,5522804,5526540,3736,"zString"
"13021",28,1,29,86,5532445,5536074,3629,"zString"
"13117",28,1,25,87,5537897,5541124,3227,"zString"
"13220",28,1,16,88,5542738,5547324,4586,"zString"
"13323",28,1,19,89,5549058,5553057,3999,"zString"
"13417",28,1,9,90,5555335,5558557,3222,"zString"
"1365",28,1,23,91,5563148,5567541,4393,"zString"
"1468",28,2,121,92,5741249,5748481,7232,"reading"
"14811",28,2,122,93,5772869,5777800,4931,"reading"
"15011",28,2,123,94,5783503,5788217,4714,"reading"
"15219",28,3,171,95,5793606,5798668,5062,"reading"
"15319",28,3,180,96,5800742,5806652,5910,"reading"
"15419",28,2,147,97,5809097,5814518,5421,"reading"
"15524",28,3,158,98,5816373,5822452,6079,"reading"
"15721",28,2,127,99,5828575,5833402,4827,"reading"
"15920",28,2,124,100,5840910,5847786,6876,"reading"
"16126",28,3,156,101,5853217,5859003,5786,"reading"
"16320",28,2,137,102,5864178,5867970,3792,"reading"
"16422",28,2,150,103,5870178,5874587,4409,"reading"
"16517",28,3,172,104,5876422,5881371,4949,"reading"
"16619",28,3,160,105,5883296,5887387,4091,"reading"
"16820",28,2,145,106,5892744,5897371,4627,"reading"
"16918",28,3,166,107,5899574,5908255,8681,"reading"
"17020",28,2,146,108,5910179,5915555,5376,"reading"
"17123",28,2,142,109,5917560,5923422,5862,"reading"
"17221",28,3,164,110,5925706,5931606,5900,"reading"
"17317",28,3,161,111,5934162,5939856,5694,"reading"
"17521",28,2,138,112,5945225,5950957,5732,"reading"
"17618",28,3,174,113,5952610,5958373,5763,"reading"
"17720",28,2,128,114,5961092,5965357,4265,"reading"
"17921",28,3,175,115,5970686,5974274,3588,"reading"
"18021",28,2,139,116,5975963,5981224,5261,"reading"
"18120",28,2,134,117,5983417,5988174,4757,"reading"
"18223",28,3,155,118,5990176,5995209,5033,"reading"
"18421",28,3,167,119,6003224,6010360,7136,"reading"
"18518",28,3,169,120,6012343,6018575,6232,"reading"
"18616",28,2,141,121,6021409,6025392,3983,"reading"
"18724",28,3,153,122,6027526,6031609,4083,"reading"
"18923",28,2,149,123,6036972,6043726,6754,"reading"
"19013",28,2,130,124,6045804,6050410,4606,"reading"
"19216",28,2,148,125,6056607,6060693,4086,"reading"
"19321",28,2,126,126,6062825,6068293,5468,"reading"
"19520",28,3,168,127,6075177,6080644,5467,"reading"
"19618",28,3,152,128,6083017,6088261,5244,"reading"
"19819",28,3,151,129,6093879,6097778,3899,"reading"
"20021",28,3,165,130,6103840,6109279,5439,"reading"
"20126",28,2,135,131,6111329,6114929,3600,"reading"
"20218",28,2,131,132,6116778,6121479,4701,"reading"
"20419",28,2,140,133,6204041,6209701,5660,"reading"
"20520",28,2,136,134,6211764,6216551,4787,"reading"
"20619",28,3,162,135,6218538,6226985,8447,"reading"
"20818",28,3,163,136,6232798,6238635,5837,"reading"
"20923",28,3,179,137,6240884,6244486,3602,"reading"
"21020",28,3,154,138,6246800,6251586,4786,"reading"
"21221",28,2,125,139,6256894,6261886,4992,"reading"
"21418",28,3,178,140,6267370,6273003,5633,"reading"
"21521",28,2,144,141,6275744,6280403,4659,"reading"
"21617",28,2,132,142,6282764,6288554,5790,"reading"
"21820",28,3,157,143,6294412,6300537,6125,"reading"
"22019",28,2,143,144,6306856,6311737,4881,"reading"
"22126",28,3,159,145,6313990,6319421,5431,"reading"
"22321",28,2,129,146,6325630,6329688,4058,"reading"
"22519",28,3,173,147,6335280,6340539,5259,"reading"
"22618",28,3,176,148,6342650,6347623,4973,"reading"
"22717",28,3,170,149,6349405,6355906,6501,"reading"
"22822",28,3,177,150,6357738,6362856,5118,"reading"
"22918",28,2,133,151,6365663,6370840,5177,"reading"
"23021",28,1,104,152,6373035,6376507,3472,"reading"
"23220",28,1,94,154,6405750,6410991,5241,"reading"
"23420",28,1,115,155,6418646,6422026,3380,"reading"
"23519",28,1,112,156,6424084,6428742,4658,"reading"
"23620",28,1,98,157,6431466,6435692,4226,"reading"
"23821",28,1,95,158,6440730,6445409,4679,"reading"
"24019",28,1,99,159,6451521,6455276,3755,"reading"
"24221",28,1,110,160,6460427,6463926,3499,"reading"
"24319",28,1,113,161,6466421,6470143,3722,"reading"
"24422",28,1,116,162,6472079,6475827,3748,"reading"
"24522",28,1,120,163,6478046,6482444,4398,"reading"
"24619",28,1,109,164,6484661,6489111,4450,"reading"
"24718",28,1,105,165,6491345,6495445,4100,"reading"
"24817",28,1,111,166,6497548,6502127,4579,"reading"
"24920",28,1,93,167,6504269,6507911,3642,"reading"
"25123",28,1,102,168,6513690,6519111,5421,"reading"
"25319",28,1,107,169,6524906,6529062,4156,"reading"
"25417",28,1,119,170,6531835,6537428,5593,"reading"
"25519",28,1,101,171,6539348,6543796,4448,"reading"
"25722",28,1,114,172,6549273,6555279,6006,"reading"
"25819",28,1,117,173,6557365,6561730,4365,"reading"
"25918",28,1,96,174,6564538,6567447,2909,"reading"
"26123",28,1,118,175,6572424,6577447,5023,"reading"
"26219",28,1,103,176,6579232,6585330,6098,"reading"
"26320",28,1,100,177,6587184,6591347,4163,"reading"
"26519",28,1,108,178,6597074,6600981,3907,"reading"
"26619",28,1,91,179,6603280,6607764,4484,"reading"
"26823",28,1,92,180,6613199,6617331,4132,"reading"
"27023",28,1,97,181,6624762,6628932,4170,"reading"
"2729",28,1,106,182,6635050,6639366,4316,"reading"
"10108",29,1,69,1,8282724,8288093,5369,"reading"
"12104",29,1,65,2,8293775,8301027,7252,"reading"
"1430",29,1,73,3,8309329,8312794,3465,"reading"
"1570",29,1,81,4,8317949,8322045,4096,"reading"
"16102",29,1,79,5,8327018,8329412,2394,"reading"
"17102",29,1,64,6,8333961,8337395,3434,"reading"
"19102",29,1,72,7,8345733,8354298,8565,"reading"
"21105",29,1,82,8,8361386,8370096,8710,"reading"
"22106",29,1,75,9,8373353,8376263,2910,"reading"
"23107",29,1,90,10,8379755,8382614,2859,"reading"
"24100",29,1,61,11,8385889,8389548,3659,"reading"
"26100",29,1,86,12,8396543,8402431,5888,"reading"
"2730",29,1,66,13,8405502,8408598,3096,"reading"
"2921",29,1,74,14,8416331,8422115,5784,"reading"
"3023",29,1,70,15,8425016,8427465,2449,"reading"
"3224",29,1,87,16,8436826,8441032,4206,"reading"
"3319",29,1,80,17,8444018,8448549,4531,"reading"
"3417",29,1,76,18,8452599,8455966,3367,"reading"
"3521",29,1,88,19,8460957,8466833,5876,"reading"
"3619",29,1,85,20,8471395,8475300,3905,"reading"
"3723",29,1,71,21,8479220,8481567,2347,"reading"
"3921",29,1,67,22,8490380,8492367,1987,"reading"
"4122",29,1,84,23,8499908,8502901,2993,"reading"
"4219",29,1,78,24,8507416,8511751,4335,"reading"
"4323",29,1,89,25,8516498,8519318,2820,"reading"
"4421",29,1,68,26,8524009,8529202,5193,"reading"
"4618",29,1,77,27,8537795,8540836,3041,"reading"
"4720",29,1,83,28,8548441,8551536,3095,"reading"
"4819",29,1,63,29,8557943,8561353,3410,"reading"
"5018",29,1,62,30,8573860,8575887,2027,"reading"
"5223",29,2,1,31,8588334,8593788,5454,"reading"
"5420",29,2,2,32,8599674,8606655,6981,"reading"
"5621",29,2,3,33,8613624,8616421,2797,"reading"
"5819",29,3,51,34,8622385,8627872,5487,"reading"
"5922",29,2,12,35,8695633,8700861,5228,"reading"
"6122",29,3,50,36,8706533,8712011,5478,"reading"
"6215",29,3,32,37,8715431,8718895,3464,"reading"
"6419",29,2,9,38,8730202,8733412,3210,"reading"
"6620",29,3,48,39,8739391,8743712,4321,"reading"
"6720",29,3,52,40,8748517,8753579,5062,"reading"
"6821",29,2,30,41,8757203,8761596,4393,"reading"
"6920",29,2,16,42,8799525,8806547,7022,"reading"
"7022",29,3,57,43,8811749,8817631,5882,"reading"
"7121",29,2,15,44,8825836,8830999,5163,"reading"
"7218",29,3,46,45,8834263,8838782,4519,"reading"
"7322",29,3,54,46,8843366,8847748,4382,"reading"
"7422",29,3,53,47,8853255,8855983,2728,"reading"
"7520",29,3,45,48,8859861,8864133,4272,"reading"
"7622",29,2,17,49,8869299,8875517,6218,"reading"
"7719",29,3,39,50,8878702,8883484,4782,"reading"
"7924",29,2,24,51,8889190,8892700,3510,"reading"
"8020",29,3,31,52,8898725,8904917,6192,"reading"
"8220",29,3,55,53,8913371,8915984,2613,"reading"
"8322",29,3,34,54,8920311,8925635,5324,"reading"
"8519",29,3,37,55,8933778,8937885,4107,"reading"
"8718",29,3,44,56,8945363,8948553,3190,"reading"
"8820",29,3,60,57,8954035,8956753,2718,"reading"
"8922",29,3,43,58,8962272,8966386,4114,"reading"
"9023",29,2,21,59,8969324,8975603,6279,"reading"
"9123",29,2,22,60,8980950,8983787,2837,"reading"
"9218",29,3,59,61,8989489,8991837,2348,"reading"
"9318",29,2,7,62,8995822,8999571,3749,"reading"
"9523",29,2,20,63,9006610,9010805,4195,"reading"
"9621",29,2,10,64,9017173,9020738,3565,"reading"
"9820",29,2,18,65,9027709,9031855,4146,"reading"
"9921",29,3,33,66,9040404,9049189,8785,"reading"
"10125",29,3,49,67,9055324,9059173,3849,"reading"
"10225",29,2,25,68,9064087,9067856,3769,"reading"
"10320",29,2,11,69,9072176,9075974,3798,"reading"
"10520",29,3,56,70,9082933,9086374,3441,"reading"
"10623",29,3,38,71,9091794,9097957,6163,"reading"
"10821",29,2,23,72,9104280,9108258,3978,"reading"
"10918",29,3,41,73,9112190,9115858,3668,"reading"
"11122",29,2,19,74,9124106,9128725,4619,"reading"
"11215",29,2,8,75,9132785,9138442,5657,"reading"
"11418",29,2,26,76,9146508,9151042,4534,"reading"
"11516",29,3,40,77,9158751,9162710,3959,"reading"
"11719",29,3,42,78,9169649,9174760,5111,"reading"
"11920",29,2,29,79,9182907,9187561,4654,"reading"
"12023",29,2,13,80,9191634,9194961,3327,"reading"
"12124",29,3,47,81,9200012,9214828,14816,"reading"
"12219",29,2,28,82,9219178,9221795,2617,"reading"
"12321",29,2,5,83,9226939,9229162,2223,"reading"
"12519",29,2,14,84,9238696,9242046,3350,"reading"
"12620",29,2,6,85,9245861,9249579,3718,"reading"
"12822",29,2,4,86,9255303,9259230,3927,"reading"
"13022",29,3,35,87,9266374,9269463,3089,"reading"
"13221",29,2,27,88,9276502,9281530,5028,"reading"
"13324",29,3,36,89,9286405,9289264,2859,"reading"
"13520",29,3,58,90,9297795,9302247,4452,"reading"
"14522",29,1,160,91,9542921,9557923,15002,"zString"
"14721",29,1,164,92,9563540,9579707,16167,"zString"
"14812",29,1,179,93,9584325,9596508,12183,"zString"
"14922",29,1,176,94,9601474,9614725,13251,"zString"
"15012",29,1,167,95,9618179,9632359,14180,"zString"
"15124",29,1,175,96,9635410,9646542,11132,"zString"
"15220",29,1,152,97,9652968,9664460,11492,"zString"
"15420",29,1,162,98,9670711,9681977,11266,"zString"
"15618",29,1,168,99,9687662,9699495,11833,"zString"
"15722",29,1,174,100,9704329,9718611,14282,"zString"
"15816",29,1,159,101,9722533,9731162,8629,"zString"
"16019",29,1,170,102,9737605,9746196,8591,"zString"
"16127",29,1,165,103,9751689,9762180,10491,"zString"
"16222",29,1,157,104,9767356,9779814,12458,"zString"
"16423",29,1,173,105,9786249,9799531,13282,"zString"
"16518",29,1,154,106,9803443,9815831,12388,"zString"
"16721",29,1,180,107,9822518,9834016,11498,"zString"
"16821",29,1,177,108,9847634,9859150,11516,"zString"
"16919",29,1,156,109,9863456,9871334,7878,"zString"
"17124",29,1,153,110,9879387,9892784,13397,"zString"
"17318",29,1,155,111,9899596,9909652,10056,"zString"
"17522",29,1,161,112,9916433,9928653,12220,"zString"
"17721",29,1,172,113,9937164,9943953,6789,"zString"
"17816",29,1,169,114,9948196,9959354,11158,"zString"
"17922",29,1,163,115,9966958,9984120,17162,"zString"
"18022",29,1,178,116,9988181,9997905,9724,"zString"
"18121",29,1,166,117,10003993,10015689,11696,"zString"
"18224",29,1,151,118,10020240,10030389,10149,"zString"
"18422",29,1,158,119,10037368,10045540,8172,"zString"
"18617",29,1,171,120,10051436,10064392,12956,"zString"
"18725",29,2,91,121,10069193,10077824,8631,"zString"
"18924",29,2,92,122,10083242,10089124,5882,"zString"
"19123",29,2,93,123,10096127,10104775,8648,"zString"
"19322",29,3,123,124,10111977,10119142,7165,"zString"
"19521",29,3,147,125,10125261,10135843,10582,"zString"
"19619",29,3,122,126,10140629,10148393,7764,"zString"
"19820",29,3,148,127,10157913,10163879,5966,"zString"
"19917",29,3,138,128,10169066,10174744,5678,"zString"
"20022",29,2,113,129,10179873,10183894,4021,"zString"
"20127",29,3,125,130,10188656,10193578,4922,"zString"
"20319",29,2,107,131,10200898,10208695,7797,"zString"
"20420",29,2,98,132,10245662,10253850,8188,"zString"
"20620",29,3,121,133,10261398,10266217,4819,"zString"
"20819",29,3,142,134,10272625,10282534,9909,"zString"
"20924",29,2,118,135,10287155,10294751,7596,"zString"
"21021",29,2,105,136,10298006,10302618,4612,"zString"
"21123",29,2,114,137,10305918,10312518,6600,"zString"
"21222",29,3,135,138,10316637,10326402,9765,"zString"
"21319",29,3,149,139,10330908,10339736,8828,"zString"
"21419",29,2,96,140,10345252,10350836,5584,"zString"
"21618",29,2,95,141,10357187,10364387,7200,"zString"
"21821",29,2,120,142,10370208,10376738,6530,"zString"
"21919",29,3,139,143,10380462,10388738,8276,"zString"
"22020",29,2,94,144,10396006,10402838,6832,"zString"
"22221",29,3,143,145,10408722,10421524,12802,"zString"
"22322",29,3,136,146,10426238,10431540,5302,"zString"
"22422",29,3,127,147,10436799,10444289,7490,"zString"
"22619",29,2,103,148,10450999,10459290,8291,"zString"
"22718",29,2,108,149,10463901,10469374,5473,"zString"
"22823",29,3,144,150,10473787,10479975,6188,"zString"
"22919",29,2,97,151,10485661,10489725,4064,"zString"
"23122",29,3,128,152,10496380,10501408,5028,"zString"
"23323",29,3,146,153,10508701,10517875,9174,"zString"
"23421",29,3,134,154,10522727,10529710,6983,"zString"
"23520",29,3,137,155,10533777,10539043,5266,"zString"
"23621",29,2,102,156,10545937,10549743,3806,"zString"
"23822",29,2,116,157,10556490,10561777,5287,"zString"
"23917",29,3,150,158,10566300,10574928,8628,"zString"
"24020",29,2,112,159,10582250,10586578,4328,"zString"
"24122",29,3,133,160,10590209,10597863,7654,"zString"
"24222",29,3,140,161,10603120,10608045,4925,"zString"
"24320",29,2,111,162,10616564,10624646,8082,"zString"
"24423",29,3,141,163,10628300,10633629,5329,"zString"
"24523",29,2,104,164,10641124,10645363,4239,"zString"
"24620",29,3,129,165,10650940,10658563,7623,"zString"
"24818",29,2,106,166,10665845,10674414,8569,"zString"
"24921",29,2,115,167,10679193,10686631,7438,"zString"
"25018",29,2,101,168,10691445,10697783,6338,"zString"
"25221",29,3,131,169,10705147,10712399,7252,"zString"
"25418",29,3,126,170,10721792,10729168,7376,"zString"
"25619",29,2,99,171,10734633,10749050,14417,"zString"
"25820",29,3,132,172,10755879,10761033,5154,"zString"
"26025",29,2,100,173,10770471,10775218,4747,"zString"
"26220",29,2,109,174,10782971,10789534,6563,"zString"
"26321",29,2,117,175,10798708,10803052,4344,"zString"
"26419",29,2,110,176,10813141,10818419,5278,"zString"
"26520",29,3,124,177,10824548,10829369,4821,"zString"
"26719",29,2,119,178,10837552,10845803,8251,"zString"
"26824",29,3,130,179,10851187,10857970,6783,"zString"
"27024",29,3,145,180,10863620,10869487,5867,"zString"
"10109",30,1,51,1,12323187,12328403,5216,"zString"
"1150",30,1,53,2,12332428,12337420,4992,"zString"
"12105",30,1,58,3,12345310,12348671,3361,"zString"
"1360",30,1,60,4,12352380,12355871,3491,"zString"
"1431",30,1,49,5,12360564,12363255,2691,"zString"
"1580",30,1,40,6,12367873,12372255,4382,"zString"
"17103",30,1,43,7,12380571,12386005,5434,"zString"
"18102",30,1,34,8,12391193,12393872,2679,"zString"
"2090",30,1,45,9,12399648,12402489,2841,"zString"
"21106",30,1,59,10,12408913,12411990,3077,"zString"
"22107",30,1,42,11,12416753,12419690,2937,"zString"
"24101",30,1,33,12,12426313,12428707,2394,"zString"
"26101",30,1,52,13,12435435,12438174,2739,"zString"
"2734",30,1,37,14,12445118,12447891,2773,"zString"
"2922",30,1,36,15,12454354,12457208,2854,"zString"
"3120",30,1,38,16,12466335,12468975,2640,"zString"
"3320",30,1,31,17,12474552,12477625,3073,"zString"
"3522",30,1,39,18,12484574,12488075,3501,"zString"
"3724",30,1,47,19,12495901,12500426,4525,"zString"
"3819",30,1,44,20,12505658,12509276,3618,"zString"
"3922",30,1,55,21,12513249,12516043,2794,"zString"
"4022",30,1,48,22,12520520,12524977,4457,"zString"
"4123",30,1,32,23,12528210,12531260,3050,"zString"
"4324",30,1,50,24,12537840,12541344,3504,"zString"
"4422",30,1,57,25,12547514,12550644,3130,"zString"
"4521",30,1,46,26,12555599,12558461,2862,"zString"
"4619",30,1,41,27,12563309,12565629,2320,"zString"
"4820",30,1,35,28,12571848,12574378,2530,"zString"
"5019",30,1,56,29,12580874,12583779,2905,"zString"
"5118",30,1,54,30,12586765,12590562,3797,"zString"
"5224",30,2,61,31,12593813,12596996,3183,"zString"
"5421",30,2,62,32,12603554,12605913,2359,"zString"
"5622",30,2,63,33,12612979,12615846,2867,"zString"
"5820",30,2,66,34,12621253,12623897,2644,"zString"
"6023",30,3,26,35,12632165,12635231,3066,"zString"
"6123",30,3,18,36,12638783,12640947,2164,"zString"
"6216",30,3,4,37,12644125,12646848,2723,"zString"
"6420",30,3,23,38,12655057,12658198,3141,"zString"
"6520",30,3,17,39,12661812,12664632,2820,"zString"
"6621",30,3,11,40,12668830,12671932,3102,"zString"
"6822",30,3,19,41,12679498,12682082,2584,"zString"
"6921",30,3,3,42,12713481,12716451,2970,"zString"
"7122",30,2,85,43,12722128,12724985,2857,"zString"
"7219",30,3,28,44,12727107,12729652,2545,"zString"
"7323",30,2,80,45,12733426,12736452,3026,"zString"
"7423",30,2,89,46,12738956,12741152,2196,"zString"
"7521",30,2,78,47,12746971,12750719,3748,"zString"
"7623",30,3,30,48,12755022,12757486,2464,"zString"
"7720",30,3,27,49,12761350,12764070,2720,"zString"
"7817",30,2,65,50,12767564,12770003,2439,"zString"
"8021",30,3,14,51,12776190,12778820,2630,"zString"
"8119",30,2,76,52,12783973,12786304,2331,"zString"
"8221",30,2,74,53,12792366,12796354,3988,"zString"
"8323",30,3,2,54,12800402,12802838,2436,"zString"
"8520",30,3,8,55,12809606,12812288,2682,"zString"
"8719",30,3,16,56,12818854,12821571,2717,"zString"
"8821",30,2,75,57,12824379,12827072,2693,"zString"
"8923",30,2,81,58,12830497,12832555,2058,"zString"
"9024",30,2,88,59,12836471,12838922,2451,"zString"
"9124",30,3,12,60,12841375,12843440,2065,"zString"
"9319",30,2,83,61,12848507,12851306,2799,"zString"
"9422",30,3,20,62,12854047,12856856,2809,"zString"
"9524",30,3,7,63,12860774,12863340,2566,"zString"
"9719",30,3,6,64,12869801,12872240,2439,"zString"
"9922",30,2,79,65,12878052,12880224,2172,"zString"
"10020",30,2,86,66,12884534,12886141,1607,"zString"
"10126",30,3,15,67,12890274,12894091,3817,"zString"
"10226",30,2,87,68,12898421,12901358,2937,"zString"
"10321",30,2,71,69,12907134,12909308,2174,"zString"
"10521",30,3,1,70,12914435,12917408,2973,"zString"
"10719",30,3,29,71,12922637,12924775,2138,"zString"
"10822",30,3,13,72,12927724,12929508,1784,"zString"
"10919",30,2,64,73,12932504,12934626,2122,"zString"
"11123",30,3,9,74,12941264,12943276,2012,"zString"
"11324",30,2,84,75,12948281,12950893,2612,"zString"
"11419",30,2,68,76,12953448,12955676,2228,"zString"
"11624",30,2,73,77,12962709,12965276,2567,"zString"
"11720",30,3,5,78,12972281,12975544,3263,"zString"
"11921",30,3,21,79,12981390,12983777,2387,"zString"
"12024",30,2,77,80,12987674,12989793,2119,"zString"
"12125",30,2,90,81,12992608,12994361,1753,"zString"
"12220",30,2,70,82,12999213,13001378,2165,"zString"
"12419",30,2,72,83,13007906,13010228,2322,"zString"
"12621",30,3,22,84,13017045,13020428,3383,"zString"
"12723",30,2,82,85,13024774,13028729,3955,"zString"
"12823",30,3,24,86,13035740,13038412,2672,"zString"
"12916",30,3,25,87,13041507,13043729,2222,"zString"
"13023",30,2,69,88,13047323,13049529,2206,"zString"
"13222",30,2,67,89,13056339,13058630,2291,"zString"
"13418",30,3,10,90,13064147,13066663,2516,"zString"
"14523",30,1,131,91,13218175,13225669,7494,"reading"
"14722",30,1,124,92,13233165,13238769,5604,"reading"
"14923",30,1,143,93,13245430,13249902,4472,"reading"
"15013",30,1,121,94,13253377,13260170,6793,"reading"
"15221",30,1,125,95,13269401,13274104,4703,"reading"
"15421",30,1,127,96,13280886,13287054,6168,"reading"
"15619",30,1,123,97,13295120,13300438,5318,"reading"
"15817",30,1,150,98,13308429,13317588,9159,"reading"
"15921",30,1,126,99,13323136,13327472,4336,"reading"
"16128",30,1,136,100,13336240,13342623,6383,"reading"
"16223",30,1,149,101,13350191,13357056,6865,"reading"
"16321",30,1,129,102,13361261,13369507,8246,"reading"
"16519",30,1,135,103,13378858,13385491,6633,"reading"
"16620",30,1,130,104,13389493,13394891,5398,"reading"
"16822",30,1,122,105,13402050,13408675,6625,"reading"
"17021",30,1,132,106,13414517,13419808,5291,"reading"
"17222",30,1,141,107,13430824,13441460,10636,"reading"
"17319",30,1,139,108,13444860,13447609,2749,"reading"
"17420",30,1,145,109,13451547,13455726,4179,"reading"
"17523",30,1,146,110,13459335,13465226,5891,"reading"
"17619",30,1,142,111,13469635,13476044,6409,"reading"
"17722",30,1,133,112,13479028,13488128,9100,"reading"
"17817",30,1,137,113,13492625,13497728,5103,"reading"
"17923",30,1,140,114,13500267,13507562,7295,"reading"
"18023",30,1,138,115,13512003,13518312,6309,"reading"
"18122",30,1,147,116,13522869,13527079,4210,"reading"
"18225",30,1,144,117,13530530,13541162,10632,"reading"
"18316",30,1,148,118,13543709,13548530,4821,"reading"
"18423",30,1,128,119,13552999,13558563,5564,"reading"
"18618",30,1,134,120,13567263,13574447,7184,"reading"
"18726",30,2,151,121,13577803,13585198,7395,"reading"
"18925",30,2,152,122,13593747,13600364,6617,"reading"
"19124",30,2,153,123,13607092,13614164,7072,"reading"
"19323",30,3,95,124,13622395,13626749,4354,"reading"
"19522",30,2,161,125,13635775,13645166,9391,"reading"
"19722",30,3,119,126,13655457,13661600,6143,"reading"
"19821",30,3,117,127,13665702,13674151,8449,"reading"
"19918",30,3,92,128,13678145,13682534,4389,"reading"
"20128",30,2,169,129,13689784,13701435,11651,"reading"
"20219",30,3,100,130,13707138,13711019,3881,"reading"
"20421",30,3,109,131,13720537,13724102,3565,"reading"
"20521",30,2,168,132,13861447,13872124,10677,"reading"
"20621",30,3,107,133,13875551,13878491,2940,"reading"
"20723",30,3,113,134,13881436,13884708,3272,"reading"
"20820",30,2,157,135,13887128,13894475,7347,"reading"
"21022",30,2,167,136,13900961,13905908,4947,"reading"
"21124",30,2,155,137,13909703,13915259,5556,"reading"
"21320",30,2,171,138,13923102,13928010,4908,"reading"
"21420",30,3,114,139,13931664,13939444,7780,"reading"
"21522",30,2,170,140,13942415,13947443,5028,"reading"
"21619",30,3,103,141,13952156,13958160,6004,"reading"
"21723",30,3,108,142,13961376,13965127,3751,"reading"
"21822",30,3,104,143,13968432,13975227,6795,"reading"
"21920",30,3,118,144,13977908,13982611,4703,"reading"
"22021",30,2,175,145,13985486,13989895,4409,"reading"
"22127",30,3,111,146,13992787,13996778,3991,"reading"
"22222",30,3,110,147,14001552,14005062,3510,"reading"
"22323",30,3,102,148,14007494,14014945,7451,"reading"
"22520",30,3,97,149,14025494,14030346,4852,"reading"
"22719",30,2,160,150,14036001,14041263,5262,"reading"
"22920",30,2,172,151,14048295,14052147,3852,"reading"
"23022",30,2,154,152,14056363,14059630,3267,"reading"
"23221",30,2,173,153,14064787,14071664,6877,"reading"
"23324",30,3,105,154,14075734,14080264,4530,"reading"
"23422",30,3,93,155,14083221,14087964,4743,"reading"
"23622",30,3,94,156,14094345,14097865,3520,"reading"
"23823",30,2,166,157,14106569,14115716,9147,"reading"
"23918",30,2,163,158,14121376,14126649,5273,"reading"
"24021",30,3,116,159,14129654,14134016,4362,"reading"
"24123",30,3,98,160,14137082,14141616,4534,"reading"
"24321",30,3,101,161,14147303,14150300,2997,"reading"
"24524",30,2,179,162,14157704,14162951,5247,"reading"
"24621",30,3,99,163,14166575,14172084,5509,"reading"
"24819",30,2,177,164,14179405,14186085,6680,"reading"
"24922",30,3,106,165,14189887,14195802,5915,"reading"
"25019",30,2,180,166,14201288,14209169,7881,"reading"
"25124",30,3,91,167,14213509,14220619,7110,"reading"
"25320",30,3,120,168,14229780,14234170,4390,"reading"
"25419",30,2,164,169,14237883,14243970,6087,"reading"
"25520",30,2,159,170,14248476,14250671,2195,"reading"
"25723",30,2,162,171,14259394,14265154,5760,"reading"
"25919",30,2,174,172,14271381,14274855,3474,"reading"
"26026",30,2,165,173,14278790,14283288,4498,"reading"
"26124",30,3,96,174,14289811,14294005,4194,"reading"
"26322",30,3,112,175,14301361,14305589,4228,"reading"
"26420",30,3,115,176,14311335,14314605,3270,"reading"
"26521",30,2,178,177,14319389,14324140,4751,"reading"
"26620",30,2,156,178,14330078,14337524,7446,"reading"
"26825",30,2,158,179,14345099,14352107,7008,"reading"
"27025",30,2,176,180,14358426,14364724,6298,"reading"
"10127",31,2,31,1,3703204,3708792,5588,"reading"
"12106",31,2,32,2,3720320,3725209,4889,"reading"
"1432",31,2,33,3,3732366,3738676,6310,"reading"
"16103",31,2,49,4,3745250,3750377,5127,"reading"
"17104",31,2,36,5,3757161,3762044,4883,"reading"
"19103",31,3,78,6,3770180,3775294,5114,"reading"
"20100",31,3,69,7,3779336,3784578,5242,"reading"
"22108",31,2,52,8,3793277,3797462,4185,"reading"
"23108",31,3,66,9,3804940,3809112,4172,"reading"
"25107",31,2,45,10,3816741,3821995,5254,"reading"
"26102",31,2,38,11,3826839,3831696,4857,"reading"
"2818",31,2,57,12,3843067,3848313,5246,"reading"
"2923",31,2,53,13,3854717,3860564,5847,"reading"
"3024",31,2,54,14,3871225,3874814,3589,"reading"
"3121",31,3,68,15,3881092,3885815,4723,"reading"
"3321",31,2,59,16,3896302,3900049,3747,"reading"
"3418",31,2,56,17,3903354,3908199,4845,"reading"
"3523",31,2,39,18,3915408,3921349,5941,"reading"
"3725",31,3,71,19,3929522,3934000,4478,"reading"
"3923",31,3,70,20,3944425,3949484,5059,"reading"
"4124",31,3,62,21,3957014,3960450,3436,"reading"
"4325",31,3,73,22,3968839,3972817,3978,"reading"
"4423",31,2,51,23,3977302,3983551,6249,"reading"
"4522",31,2,41,24,3986826,3990618,3792,"reading"
"4721",31,3,61,25,3997406,4002852,5446,"reading"
"4924",31,3,80,26,4011016,4018336,7320,"reading"
"5020",31,3,74,27,4026453,4030453,4000,"reading"
"5119",31,2,34,28,4036221,4040336,4115,"reading"
"5313",31,3,87,29,4047993,4052836,4843,"reading"
"5422",31,2,47,30,4055857,4061271,5414,"reading"
"5511",31,3,79,31,4064673,4068987,4314,"reading"
"5623",31,3,89,32,4071568,4075905,4337,"reading"
"5714",31,3,65,33,4080161,4087588,7427,"reading"
"5923",31,2,46,34,4094531,4098356,3825,"reading"
"6024",31,3,72,35,4101037,4105322,4285,"reading"
"6217",31,2,35,36,4111993,4115206,3213,"reading"
"6421",31,3,77,37,4121288,4124990,3702,"reading"
"6521",31,3,75,38,4127704,4132223,4519,"reading"
"6622",31,3,81,39,4134751,4139323,4572,"reading"
"6721",31,2,60,40,4142506,4146423,3917,"reading"
"6823",31,2,58,41,4150812,4156124,5312,"reading"
"6922",31,3,83,42,4404990,4409018,4028,"reading"
"7023",31,2,37,43,4411938,4415818,3880,"reading"
"7220",31,3,88,44,4422638,4427502,4864,"reading"
"7324",31,2,43,45,4429681,4433269,3588,"reading"
"7424",31,2,50,46,4435360,4439819,4459,"reading"
"7522",31,2,40,47,4442473,4447719,5246,"reading"
"7721",31,2,48,48,4457215,4461587,4372,"reading"
"7818",31,2,55,49,4464265,4468437,4172,"reading"
"7925",31,3,67,50,4471872,4475505,3633,"reading"
"8120",31,3,86,51,4483041,4488971,5930,"reading"
"8222",31,3,85,52,4492051,4496405,4354,"reading"
"8324",31,3,64,53,4499095,4502922,3827,"reading"
"8521",31,3,63,54,4510899,4515755,4856,"reading"
"8720",31,2,44,55,4522487,4526172,3685,"reading"
"8822",31,3,76,56,4531644,4534623,2979,"reading"
"8924",31,3,82,57,4539787,4543423,3636,"reading"
"9025",31,3,90,58,4546835,4550773,3938,"reading"
"9125",31,2,42,59,4554164,4559324,5160,"reading"
"9320",31,3,84,60,4567426,4571940,4514,"reading"
"9423",31,1,16,61,4575692,4579558,3866,"reading"
"9525",31,1,8,62,4582610,4587958,5348,"reading"
"9720",31,1,2,63,4594443,4600142,5699,"reading"
"9923",31,1,27,64,4608711,4613608,4897,"reading"
"10021",31,1,29,65,4616804,4622175,5371,"reading"
"10128",31,1,15,66,4625596,4629909,4313,"reading"
"10227",31,1,12,67,4631944,4635993,4049,"reading"
"10423",31,1,26,68,4642079,4646660,4581,"reading"
"10522",31,1,6,69,4650367,4655544,5177,"reading"
"10720",31,1,19,70,4663107,4667744,4637,"reading"
"10823",31,1,17,71,4670971,4677144,6173,"reading"
"10920",31,1,18,72,4682091,4686578,4487,"reading"
"11020",31,1,22,73,4694983,4698461,3478,"reading"
"11124",31,1,5,74,4702397,4706279,3882,"reading"
"11325",31,1,4,75,4715060,4719412,4352,"reading"
"11517",31,1,9,76,4725824,4729546,3722,"reading"
"11721",31,1,20,77,4734853,4739030,4177,"reading"
"11817",31,1,7,78,4743969,4748730,4761,"reading"
"12025",31,1,23,79,4756224,4760114,3890,"reading"
"12126",31,1,3,80,4763094,4766898,3804,"reading"
"12322",31,1,25,81,4772683,4777214,4531,"reading"
"12420",31,1,14,82,4781679,4786098,4419,"reading"
"12520",31,1,1,83,4789115,4792815,3700,"reading"
"12724",31,1,24,84,4799616,4805382,5766,"reading"
"12824",31,1,11,85,4810980,4815899,4919,"reading"
"13024",31,1,10,86,4990808,4995805,4997,"reading"
"13223",31,1,30,87,5002904,5009223,6319,"reading"
"13325",31,1,28,88,5011963,5014856,2893,"reading"
"13419",31,1,21,89,5017684,5022439,4755,"reading"
"13521",31,1,13,90,5026174,5029840,3666,"reading"
"14524",31,2,121,91,5225564,5229548,3984,"zString"
"14723",31,2,122,92,5239077,5244516,5439,"zString"
"14924",31,2,123,93,5259399,5264449,5050,"zString"
"15125",31,2,147,94,5273849,5279650,5801,"zString"
"15222",31,2,149,95,5283589,5289184,5595,"zString"
"15320",31,3,172,96,5291500,5297701,6201,"zString"
"15422",31,2,127,97,5300486,5306601,6115,"zString"
"15620",31,3,163,98,5312952,5317801,4849,"zString"
"15723",31,2,145,99,5322200,5326118,3918,"zString"
"15818",31,3,174,100,5328351,5333438,5087,"zString"
"15922",31,3,153,101,5336428,5340402,3974,"zString"
"16129",31,2,137,102,5346760,5350389,3629,"zString"
"16224",31,3,152,103,5355462,5360436,4974,"zString"
"16424",31,3,170,104,5366212,5370353,4141,"zString"
"16520",31,3,164,105,5374007,5379337,5330,"zString"
"16621",31,2,134,106,5381492,5386470,4978,"zString"
"16722",31,3,168,107,5392186,5397254,5068,"zString"
"16823",31,3,180,108,5399997,5405638,5641,"zString"
"16920",31,3,160,109,5408515,5416555,8040,"zString"
"17125",31,3,173,110,5421345,5425688,4343,"zString"
"17223",31,2,148,111,5430056,5435722,5666,"zString"
"17320",31,3,179,112,5438024,5441672,3648,"zString"
"17421",31,2,132,113,5444434,5449873,5439,"zString"
"17620",31,3,175,114,5457304,5460706,3402,"zString"
"17723",31,3,167,115,5463955,5468640,4685,"zString"
"17818",31,2,126,116,5478023,5482007,3984,"zString"
"18024",31,3,178,117,5486988,5490524,3536,"zString"
"18123",31,2,142,118,5495637,5499108,3471,"zString"
"18226",31,3,177,119,5502190,5506741,4551,"zString"
"18317",31,2,128,120,5509814,5514908,5094,"zString"
"18519",31,2,125,121,5520208,5523809,3601,"zString"
"18727",31,2,129,122,5528889,5533459,4570,"zString"
"18926",31,2,143,123,5538782,5545942,7160,"zString"
"19014",31,2,135,124,5548752,5553842,5090,"zString"
"19125",31,2,140,125,5556654,5563243,6589,"zString"
"19217",31,2,144,126,5567694,5574676,6982,"zString"
"19324",31,2,130,127,5585028,5589444,4416,"zString"
"19523",31,2,139,128,5594617,5599178,4561,"zString"
"19620",31,2,136,129,5602401,5608661,6260,"zString"
"19723",31,3,156,130,5612423,5618995,6572,"zString"
"19919",31,3,166,131,5625079,5631979,6900,"zString"
"20023",31,3,155,132,5747208,5751885,4677,"zString"
"20220",31,2,146,133,5757222,5762301,5079,"zString"
"20320",31,3,169,134,5765641,5769871,4230,"zString"
"20422",31,3,171,135,5772033,5776402,4369,"zString"
"20522",31,2,138,136,5779887,5784753,4866,"zString"
"20622",31,3,151,137,5787609,5792219,4610,"zString"
"20821",31,3,154,138,5798511,5803136,4625,"zString"
"21023",31,3,161,139,5812049,5816671,4622,"zString"
"21223",31,3,157,140,5823769,5828288,4519,"zString"
"21421",31,3,158,141,5836854,5842404,5550,"zString"
"21620",31,2,124,142,5851053,5856905,5852,"zString"
"21823",31,3,165,143,5861540,5868072,6532,"zString"
"21921",31,3,159,144,5870446,5875272,4826,"zString"
"22128",31,3,176,145,5880258,5886523,6265,"zString"
"22223",31,2,133,146,5890026,5896473,6447,"zString"
"22324",31,2,150,147,5902013,5907973,5960,"zString"
"22423",31,3,162,148,5913699,5918707,5008,"zString"
"22620",31,2,141,149,5923160,5928391,5231,"zString"
"22720",31,2,131,150,5933259,5937574,4315,"zString"
"22921",31,1,100,151,5943613,5949208,5595,"zString"
"23123",31,1,102,152,5955008,5960325,5317,"zString"
"23325",31,1,110,153,5971469,5975842,4373,"zString"
"23423",31,1,103,154,5979490,5984126,4636,"zString"
"23521",31,1,94,155,5986861,5991410,4549,"zString"
"23720",31,1,119,156,5998584,6002978,4394,"zString"
"23824",31,1,105,157,6007043,6010710,3667,"zString"
"23919",31,1,97,158,6015060,6018210,3150,"zString"
"24124",31,1,91,159,6023117,6028011,4894,"zString"
"24322",31,1,112,160,6033733,6037680,3947,"zString"
"24424",31,1,95,161,6040231,6047145,6914,"zString"
"24622",31,1,113,162,6051726,6056312,4586,"zString"
"24719",31,1,104,163,6059351,6064795,5444,"zString"
"24820",31,1,101,164,6067449,6071362,3913,"zString"
"25020",31,1,98,165,6079685,6085763,6078,"zString"
"25222",31,1,117,166,6093672,6096946,3274,"zString"
"25321",31,1,96,167,6101493,6105731,4238,"zString"
"25521",31,1,116,168,6112791,6118231,5440,"zString"
"25620",31,1,114,169,6121544,6125281,3737,"zString"
"25724",31,1,118,170,6128035,6132965,4930,"zString"
"25821",31,1,93,171,6135902,6140565,4663,"zString"
"26027",31,1,115,172,6145968,6149684,3716,"zString"
"26125",31,1,108,173,6152104,6158515,6411,"zString"
"26221",31,1,111,174,6161675,6167965,6290,"zString"
"26323",31,1,99,175,6170038,6175516,5478,"zString"
"26522",31,1,106,176,6181763,6186316,4553,"zString"
"26621",31,1,107,177,6190673,6194602,3929,"zString"
"26720",31,1,92,178,6198325,6203517,5192,"zString"
"26918",31,1,109,179,6208191,6211553,3362,"zString"
"27026",31,1,120,180,6214632,6220452,5820,"zString"
"10129",32,2,1,1,6839152,6842291,3139,"zString"
"12107",32,2,2,2,6847907,6851474,3567,"zString"
"1433",32,2,3,3,6856497,6859709,3212,"zString"
"16104",32,2,10,4,6871657,6874925,3268,"zString"
"18103",32,3,58,5,6879415,6882859,3444,"zString"
"19104",32,2,8,6,6885811,6890626,4815,"zString"
"21107",32,3,54,7,6899693,6902660,2967,"zString"
"22109",32,3,43,8,6906017,6909260,3243,"zString"
"23109",32,2,27,9,6917723,6920910,3187,"zString"
"24102",32,2,18,10,6927235,6930227,2992,"zString"
"25108",32,3,32,11,6935323,6938461,3138,"zString"
"2735",32,3,39,12,6944438,6948528,4090,"zString"
"2924",32,2,13,13,6954250,6957778,3528,"zString"
"3025",32,3,40,14,6962609,6966429,3820,"zString"
"3225",32,2,23,15,6971418,6976562,5144,"zString"
"3322",32,3,35,16,6983317,6989329,6012,"zString"
"3524",32,2,5,17,6999306,7004780,5474,"zString"
"3726",32,3,33,18,7010364,7013464,3100,"zString"
"3924",32,3,38,19,7020049,7024947,4898,"zString"
"4125",32,2,19,20,7028692,7032447,3755,"zString"
"4220",32,2,26,21,7035476,7039214,3738,"zString"
"4326",32,3,48,22,7043090,7046748,3658,"zString"
"4424",32,3,49,23,7048978,7052698,3720,"zString"
"4523",32,2,12,24,7056453,7059331,2878,"zString"
"4722",32,2,11,25,7063642,7068282,4640,"zString"
"4925",32,3,34,26,7072380,7077949,5569,"zString"
"5120",32,3,44,27,7086378,7090733,4355,"zString"
"5225",32,2,30,28,7093683,7098300,4617,"zString"
"5314",32,2,17,29,7102156,7106400,4244,"zString"
"5423",32,3,41,30,7109561,7114283,4722,"zString"
"5624",32,3,42,31,7119544,7122967,3423,"zString"
"5821",32,3,52,32,7127353,7131868,4515,"zString"
"5924",32,2,15,33,7135026,7140184,5158,"zString"
"6025",32,3,57,34,7145573,7150269,4696,"zString"
"6124",32,3,46,35,7153487,7156935,3448,"zString"
"6218",32,3,50,36,7160473,7164235,3762,"zString"
"6324",32,2,7,37,7167389,7171802,4413,"zString"
"6522",32,2,6,38,7178166,7181153,2987,"zString"
"6722",32,2,21,39,7185773,7189720,3947,"zString"
"6824",32,3,60,40,7192915,7198003,5088,"zString"
"6923",32,2,20,41,7200215,7204637,4422,"zString"
"7024",32,2,22,42,7322340,7325708,3368,"zString"
"7123",32,3,55,43,7328116,7331541,3425,"zString"
"7221",32,3,36,44,7336655,7340308,3653,"zString"
"7425",32,2,14,45,7345256,7348691,3435,"zString"
"7523",32,2,29,46,7351813,7355141,3328,"zString"
"7624",32,3,59,47,7358877,7361775,2898,"zString"
"7722",32,2,4,48,7364081,7368376,4295,"zString"
"7926",32,2,16,49,7372511,7376909,4398,"zString"
"8022",32,3,51,50,7380650,7384726,4076,"zString"
"8121",32,3,37,51,7388785,7391660,2875,"zString"
"8325",32,2,24,52,7399226,7403144,3918,"zString"
"8422",32,2,28,53,7405939,7410343,4404,"zString"
"8522",32,3,53,54,7413421,7416744,3323,"zString"
"8619",32,2,25,55,7419966,7422544,2578,"zString"
"8721",32,3,31,56,7426881,7430628,3747,"zString"
"8925",32,2,9,57,7435764,7438911,3147,"zString"
"9126",32,3,56,58,7443320,7447411,4091,"zString"
"9219",32,3,45,59,7451587,7453995,2408,"zString"
"9321",32,3,47,60,7456687,7459412,2725,"zString"
"9424",32,1,86,61,7463957,7466762,2805,"zString"
"9526",32,1,62,62,7471701,7474146,2445,"zString"
"9721",32,1,81,63,7478642,7481213,2571,"zString"
"9821",32,1,64,64,7483766,7488046,4280,"zString"
"10022",32,1,73,65,7492591,7495463,2872,"zString"
"10130",32,1,85,66,7498461,7502264,3803,"zString"
"10228",32,1,77,67,7505460,7508580,3120,"zString"
"10322",32,1,70,68,7511566,7514564,2998,"zString"
"10523",32,1,80,69,7520209,7524598,4389,"zString"
"10624",32,1,84,70,7526898,7530448,3550,"zString"
"10721",32,1,79,71,7533584,7537965,4381,"zString"
"10824",32,1,66,72,7540775,7543948,3173,"zString"
"11021",32,1,68,73,7554640,7559949,5309,"zString"
"11216",32,1,82,74,7564520,7568582,4062,"zString"
"11326",32,1,74,75,7571443,7577083,5640,"zString"
"11420",32,1,71,76,7583839,7588650,4811,"zString"
"11625",32,1,69,77,7594742,7600050,5308,"zString"
"11818",32,1,72,78,7605852,7610501,4649,"zString"
"12026",32,1,75,79,7620286,7624217,3931,"zString"
"12127",32,1,87,80,7628759,7633568,4809,"zString"
"12221",32,1,89,81,7636703,7641602,4899,"zString"
"12323",32,1,65,82,7646243,7651052,4809,"zString"
"12521",32,1,83,83,7657336,7661553,4217,"zString"
"12622",32,1,90,84,7664725,7669769,5044,"zString"
"12725",32,1,63,85,7673661,7677453,3792,"zString"
"12917",32,1,67,86,7681532,7685736,4204,"zString"
"13118",32,1,78,87,7690117,7695670,5553,"zString"
"13224",32,1,88,88,7698574,7703287,4713,"zString"
"13326",32,1,61,89,7706875,7710787,3912,"zString"
"13522",32,1,76,90,7716022,7720538,4516,"zString"
"14525",32,2,91,91,7981729,7991433,9704,"reading"
"14724",32,2,92,92,7999857,8008617,8760,"reading"
"14925",32,2,93,93,8016703,8023068,6365,"reading"
"15126",32,3,136,94,8029237,8037651,8414,"reading"
"15223",32,2,102,95,8040567,8046985,6418,"reading"
"15423",32,3,139,96,8053533,8058919,5386,"reading"
"15525",32,3,143,97,8062044,8070152,8108,"reading"
"15621",32,2,105,98,8072493,8079870,7377,"reading"
"15724",32,2,101,99,8081979,8088470,6491,"reading"
"15923",32,3,137,100,8094352,8102187,7835,"reading"
"16020",32,3,129,101,8104788,8112571,7783,"reading"
"16225",32,2,96,102,8120326,8128521,8195,"reading"
"16425",32,3,140,103,8134845,8142455,7610,"reading"
"16521",32,3,130,104,8145204,8153455,8251,"reading"
"16723",32,2,94,105,8158093,8164839,6746,"reading"
"16921",32,3,124,106,8170048,8177623,7575,"reading"
"17126",32,2,100,107,8183851,8190656,6805,"reading"
"17321",32,2,117,108,8196173,8202840,6667,"reading"
"17422",32,3,131,109,8205468,8212041,6573,"reading"
"17621",32,3,146,110,8217939,8224091,6152,"reading"
"17724",32,3,123,111,8226052,8231641,5589,"reading"
"17924",32,2,97,112,8236898,8242409,5511,"reading"
"18124",32,3,127,113,8247439,8254959,7520,"reading"
"18318",32,3,126,114,8260246,8264426,4180,"reading"
"18520",32,2,114,115,8271124,8280643,9519,"reading"
"18619",32,3,147,116,8282980,8288310,5330,"reading"
"18728",32,2,99,117,8290598,8296077,5479,"reading"
"18927",32,2,115,118,8305152,8309894,4742,"reading"
"19015",32,2,111,119,8312403,8317627,5224,"reading"
"19126",32,3,150,120,8320040,8327296,7256,"reading"
"19218",32,2,116,121,8329606,8335245,5639,"reading"
"19325",32,2,98,122,8337990,8343095,5105,"reading"
"19524",32,2,109,123,8348063,8354112,6049,"reading"
"19621",32,2,103,124,8357353,8364396,7043,"reading"
"19724",32,3,141,125,8366649,8380813,14164,"reading"
"19822",32,3,132,126,8383685,8390347,6662,"reading"
"20024",32,2,106,127,8397346,8406081,8735,"reading"
"20129",32,2,108,128,8408133,8421581,13448,"reading"
"20221",32,3,121,129,8423895,8432715,8820,"reading"
"20423",32,3,134,130,8438269,8443849,5580,"reading"
"20523",32,3,138,131,8446430,8453499,7069,"reading"
"20623",32,2,113,132,8616294,8623974,7680,"reading"
"20724",32,2,112,133,8626423,8631241,4818,"reading"
"20822",32,3,133,134,8634456,8644009,9553,"reading"
"20925",32,2,107,135,8646059,8651225,5166,"reading"
"21024",32,3,145,136,8653996,8660126,6130,"reading"
"21125",32,3,149,137,8662909,8669643,6734,"reading"
"21224",32,3,135,138,8671852,8678426,6574,"reading"
"21321",32,2,119,139,8684044,8689877,5833,"reading"
"21422",32,3,142,140,8691987,8699727,7740,"reading"
"21523",32,2,104,141,8701571,8708677,7106,"reading"
"21621",32,2,110,142,8711546,8716611,5065,"reading"
"21724",32,3,125,143,8719444,8726028,6584,"reading"
"21922",32,3,122,144,8734173,8744112,9939,"reading"
"22129",32,3,144,145,8750656,8757862,7206,"reading"
"22224",32,2,95,146,8760710,8768479,7769,"reading"
"22424",32,3,128,147,8774628,8779780,5152,"reading"
"22621",32,2,120,148,8786312,8797164,10852,"reading"
"22721",32,3,148,149,8799611,8805914,6303,"reading"
"22824",32,2,118,150,8808382,8814197,5815,"reading"
"22922",32,1,162,151,8816271,8822731,6460,"reading"
"23124",32,1,161,152,8830585,8836465,5880,"reading"
"23326",32,1,168,153,8842480,8848165,5685,"reading"
"23424",32,1,163,154,8850645,8856616,5971,"reading"
"23522",32,1,172,155,8859115,8866550,7435,"reading"
"23623",32,1,159,156,8869264,8884550,15286,"reading"
"23825",32,1,166,157,8891809,8898001,6192,"reading"
"23920",32,1,177,158,8900747,8916085,15338,"reading"
"24022",32,1,176,159,8918717,8924051,5334,"reading"
"24125",32,1,153,160,8926411,8930868,4457,"reading"
"24323",32,1,160,161,8936783,8947286,10503,"reading"
"24525",32,1,154,162,8955129,8961286,6157,"reading"
"24720",32,1,174,163,8967736,8974853,7117,"reading"
"24821",32,1,180,164,8978936,8984486,5550,"reading"
"24923",32,1,170,165,8988191,8995837,7646,"reading"
"25021",32,1,178,166,8998611,9005787,7176,"reading"
"25125",32,1,152,167,9011447,9018888,7441,"reading"
"25322",32,1,167,168,9025489,9032888,7399,"reading"
"25420",32,1,165,169,9035719,9042389,6670,"reading"
"25522",32,1,175,170,9047586,9054072,6486,"reading"
"25621",32,1,173,171,9058033,9064706,6673,"reading"
"25725",32,1,164,172,9068359,9081406,13047,"reading"
"25822",32,1,171,173,9084640,9092357,7717,"reading"
"25920",32,1,155,174,9095708,9102624,6916,"reading"
"26126",32,1,179,175,9110682,9115658,4976,"reading"
"26222",32,1,156,176,9118160,9125492,7332,"reading"
"26421",32,1,157,177,9133147,9142559,9412,"reading"
"26622",32,1,151,178,9148944,9154142,5198,"reading"
"26826",32,1,158,179,9162518,9168293,5775,"reading"
"27027",32,1,169,180,9174084,9182660,8576,"reading"
"1434",33,1,52,1,2177206,2179621,2415,"reading"
"1590",33,1,47,2,2181833,2185437,3604,"reading"
"16105",33,1,45,3,2187807,2191054,3247,"reading"
"17105",33,1,38,4,2193608,2196571,2963,"reading"
"19105",33,1,55,5,2201645,2205422,3777,"reading"
"20101",33,1,40,6,2208159,2211538,3379,"reading"
"22130",33,1,33,7,2217081,2220672,3591,"reading"
"24103",33,1,42,8,2225884,2228989,3105,"reading"
"26103",33,1,53,9,2236246,2240240,3994,"reading"
"2736",33,1,32,10,2242805,2245757,2952,"reading"
"2925",33,1,34,11,2250875,2254657,3782,"reading"
"3122",33,1,44,12,2259772,2262891,3119,"reading"
"3226",33,1,48,13,2265256,2269257,4001,"reading"
"3323",33,1,39,14,2271289,2274524,3235,"reading"
"3525",33,1,57,15,2279515,2282957,3442,"reading"
"3620",33,1,56,16,2285220,2288258,3038,"reading"
"3727",33,1,35,17,2290925,2293774,2849,"reading"
"3925",33,1,37,18,2299728,2302842,3114,"reading"
"4126",33,1,49,19,2308047,2311542,3495,"reading"
"4221",33,1,43,20,2314432,2317626,3194,"reading"
"4327",33,1,59,21,2319911,2322909,2998,"reading"
"4425",33,1,60,22,2325839,2329043,3204,"reading"
"4524",33,1,31,23,2331537,2334510,2973,"reading"
"4723",33,1,41,24,2340579,2343626,3047,"reading"
"4926",33,1,50,25,2350062,2352660,2598,"reading"
"5021",33,1,54,26,2355723,2358777,3054,"reading"
"5121",33,1,36,27,2362106,2366827,4721,"reading"
"5315",33,1,51,28,2371811,2375578,3767,"reading"
"5424",33,1,46,29,2378876,2381811,2935,"reading"
"5512",33,1,58,30,2385112,2388678,3566,"reading"
"5625",33,2,61,31,2390936,2394662,3726,"reading"
"5822",33,2,62,32,2399766,2403045,3279,"reading"
"6026",33,2,63,33,2408082,2411028,2946,"reading"
"6219",33,3,8,34,2420672,2426296,5624,"reading"
"6422",33,2,89,35,2432386,2435513,3127,"reading"
"6523",33,2,75,36,2438522,2441363,2841,"reading"
"6623",33,2,68,37,2444034,2447280,3246,"reading"
"6825",33,2,74,38,2453276,2455930,2654,"reading"
"6924",33,2,66,39,2459012,2461014,2002,"reading"
"7124",33,3,1,40,2468282,2472681,4399,"reading"
"7325",33,2,65,41,2477395,2480398,3003,"reading"
"7524",33,2,79,42,2550113,2552834,2721,"reading"
"7625",33,3,26,43,2556950,2560467,3517,"reading"
"7723",33,2,85,44,2565084,2568734,3650,"reading"
"7819",33,3,25,45,2573276,2575801,2525,"reading"
"7927",33,3,3,46,2581181,2583735,2554,"reading"
"8122",33,3,30,47,2592486,2595018,2532,"reading"
"8223",33,2,64,48,2601824,2605136,3312,"reading"
"8423",33,3,13,49,2612018,2615836,3818,"reading"
"8523",33,3,6,50,2678194,2681021,2827,"reading"
"8722",33,2,73,51,2685537,2688238,2701,"reading"
"8823",33,3,5,52,2695689,2699239,3550,"reading"
"9026",33,2,86,53,2706406,2710022,3616,"reading"
"9127",33,3,19,54,2712273,2715756,3483,"reading"
"9220",33,3,22,55,2722599,2726290,3691,"reading"
"9322",33,3,24,56,2728985,2732657,3672,"reading"
"9425",33,3,28,57,2736150,2739323,3173,"reading"
"9527",33,2,84,58,2741494,2744557,3063,"reading"
"9622",33,3,14,59,2748067,2750257,2190,"reading"
"9722",33,2,88,60,2754611,2757790,3179,"reading"
"9822",33,3,16,61,2763121,2766941,3820,"reading"
"9924",33,2,67,62,2770233,2772508,2275,"reading"
"10131",33,3,29,63,2779781,2782408,2627,"reading"
"10323",33,2,78,65,2868512,2870765,2253,"reading"
"10424",33,3,20,66,2873538,2875849,2311,"reading"
"10524",33,3,18,67,2878597,2881266,2669,"reading"
"10625",33,3,17,68,2883945,2887249,3304,"reading"
"10722",33,3,11,69,2890584,2893333,2749,"reading"
"10921",33,3,7,70,2899721,2902166,2445,"reading"
"11125",33,2,83,71,2908972,2911333,2361,"reading"
"11217",33,3,23,72,2915057,2917634,2577,"reading"
"11327",33,3,9,73,2921109,2923850,2741,"reading"
"11518",33,2,70,74,2928788,2931217,2429,"reading"
"11722",33,3,27,75,2939194,2941901,2707,"reading"
"11819",33,2,77,76,2944960,2947484,2524,"reading"
"11922",33,2,80,77,2949779,2952785,3006,"reading"
"12027",33,3,21,78,2957371,2960302,2931,"reading"
"12128",33,2,72,79,2964504,2966752,2248,"reading"
"12324",33,2,81,80,2972275,2974769,2494,"reading"
"12421",33,3,12,81,2979061,2981802,2741,"reading"
"12623",33,2,82,82,2987960,2991203,3243,"reading"
"12726",33,2,90,83,2994095,2996170,2075,"reading"
"12825",33,3,10,84,2998271,3000236,1965,"reading"
"13025",33,3,15,85,3006366,3008703,2337,"reading"
"13119",33,2,76,86,3012923,3015037,2114,"reading"
"13225",33,2,71,87,3021078,3024237,3159,"reading"
"13420",33,3,2,88,3032176,3034271,2095,"reading"
"1366",33,2,87,89,3041061,3043387,2326,"reading"
"1371",33,2,69,90,3047488,3049638,2150,"reading"
"1392",33,3,4,91,3102944,3105757,2813,"reading"
"15014",33,1,132,92,3301707,3306366,4659,"zString"
"15224",33,1,139,93,3310637,3315083,4446,"zString"
"15321",33,1,135,94,3318448,3322649,4201,"zString"
"15424",33,1,122,95,3326436,3331017,4581,"zString"
"15622",33,1,137,96,3335425,3339033,3608,"zString"
"15725",33,1,143,97,3344534,3350701,6167,"zString"
"15819",33,1,149,98,3353763,3357834,4071,"zString"
"15924",33,1,138,99,3360028,3363119,3091,"zString"
"16021",33,1,147,100,3366095,3370367,4272,"zString"
"16130",33,1,134,101,3374501,3378135,3634,"zString"
"16226",33,1,128,102,3381416,3385701,4285,"zString"
"16426",33,1,127,103,3390536,3394219,3683,"zString"
"16622",33,1,144,104,3401568,3404786,3218,"zString"
"16724",33,1,125,105,3407068,3409403,2335,"zString"
"16922",33,1,130,106,3414779,3416803,2024,"zString"
"17127",33,1,141,107,3423132,3425753,2621,"zString"
"17224",33,1,142,108,3428754,3431453,2699,"zString"
"17322",33,1,150,109,3433973,3436603,2630,"zString"
"17423",33,1,124,110,3443224,3448404,5180,"zString"
"17622",33,1,131,111,3453326,3458221,4895,"zString"
"17819",33,1,148,112,3463648,3468855,5207,"zString"
"17925",33,1,146,113,3472271,3476955,4684,"zString"
"18025",33,1,145,114,3479858,3482872,3014,"zString"
"18125",33,1,133,115,3486207,3489589,3382,"zString"
"18227",33,1,140,116,3492272,3495389,3117,"zString"
"18319",33,1,126,117,3499063,3502522,3459,"zString"
"18521",33,1,121,118,3508194,3510640,2446,"zString"
"18729",33,1,129,119,3515341,3518523,3182,"zString"
"18928",33,1,136,120,3523740,3528157,4417,"zString"
"19016",33,1,123,121,3530106,3533207,3101,"zString"
"19219",33,2,151,122,3538708,3543124,4416,"zString"
"19422",33,2,152,123,3548764,3553307,4543,"zString"
"19622",33,2,153,124,3559108,3562275,3167,"zString"
"19823",33,3,117,125,3566093,3568641,2548,"zString"
"19920",33,3,105,126,3571395,3573642,2247,"zString"
"20025",33,2,172,127,3575782,3578808,3026,"zString"
"20130",33,3,102,128,3582402,3585009,2607,"zString"
"20321",33,3,111,129,3590283,3592892,2609,"zString"
"20424",33,3,99,130,3595060,3598426,3366,"zString"
"20624",33,3,104,131,3603190,3607109,3919,"zString"
"20725",33,2,166,132,3609638,3614309,4671,"zString"
"20823",33,3,95,133,3677958,3680745,2787,"zString"
"21025",33,2,170,134,3685629,3688495,2866,"zString"
"21126",33,2,164,135,3691628,3694913,3285,"zString"
"21225",33,3,93,136,3697897,3700913,3016,"zString"
"21423",33,2,173,137,3705975,3707946,1971,"zString"
"21524",33,2,154,138,3712467,3714946,2479,"zString"
"21725",33,3,108,139,3719071,3722446,3375,"zString"
"21824",33,3,101,140,3724514,3727130,2616,"zString"
"22022",33,2,165,141,3732635,3736030,3395,"zString"
"22131",33,3,110,142,3827859,3830307,2448,"zString"
"22225",33,2,174,143,3832401,3834769,2368,"zString"
"22325",33,3,97,144,3837241,3839136,1895,"zString"
"22521",33,3,92,145,3843846,3847486,3640,"zString"
"22722",33,2,169,146,3852546,3855107,2561,"zString"
"22825",33,2,179,147,3857675,3860386,2711,"zString"
"22923",33,2,161,148,3862767,3865404,2637,"zString"
"23125",33,2,157,149,3870004,3872737,2733,"zString"
"23327",33,3,109,150,3878560,3880827,2267,"zString"
"23425",33,2,163,151,3883773,3887437,3664,"zString"
"23523",33,3,100,152,3929640,3933239,3599,"zString"
"23721",33,2,171,153,3938059,3940756,2697,"zString"
"23826",33,3,91,154,3943344,3946573,3229,"zString"
"24023",33,2,156,155,3950637,3955357,4720,"zString"
"24223",33,3,120,156,3959537,3963357,3820,"zString"
"24324",33,2,167,157,3965401,3969140,3739,"zString"
"24425",33,2,155,158,3971767,3975541,3774,"zString"
"24623",33,2,175,159,3981141,3985125,3984,"zString"
"24721",33,2,177,160,3988504,3991525,3021,"zString"
"24822",33,2,160,161,3995681,3999842,4161,"zString"
"25022",33,3,98,162,4005119,4008692,3573,"zString"
"25223",33,3,113,163,4038607,4040526,1919,"zString"
"25323",33,3,119,164,4042352,4044860,2508,"zString"
"25421",33,2,158,165,4046780,4048926,2146,"zString"
"25622",33,3,114,166,4053727,4055660,1933,"zString"
"25726",33,3,103,167,4059241,4061410,2169,"zString"
"25823",33,2,162,168,4063758,4066344,2586,"zString"
"26028",33,2,159,169,4070435,4073027,2592,"zString"
"26223",33,2,168,170,4076946,4080361,3415,"zString"
"26324",33,3,116,171,4082195,4085728,3533,"zString"
"26422",33,3,94,172,4087695,4090611,2916,"zString"
"26623",33,2,176,173,4094635,4097811,3176,"zString"
"26721",33,3,118,174,4099838,4102811,2973,"zString"
"26827",33,3,96,175,4104670,4108261,3591,"zString"
"27028",33,3,107,176,4112134,4114929,2795,"zString"
"27111",33,2,180,177,4117065,4120679,3614,"zString"
"27210",33,3,112,178,4122632,4126096,3464,"zString"
"2737",33,3,115,179,4128581,4131262,2681,"zString"
"2743",33,3,106,180,4133310,4136346,3036,"zString"
"2752",33,2,178,181,4138371,4140713,2342,"zString"
"10132",34,1,18,1,6026449,6029997,3548,"zString"
"1160",34,1,1,2,6032792,6035481,2689,"zString"
"1367",34,1,2,3,6040993,6044414,3421,"zString"
"15100",34,1,6,4,6049325,6052231,2906,"zString"
"17106",34,1,26,5,6058729,6062131,3402,"zString"
"18104",34,1,14,6,6065716,6068215,2499,"zString"
"19106",34,1,28,7,6070260,6074065,3805,"zString"
"20102",34,1,27,8,6076368,6080066,3698,"zString"
"21108",34,1,12,9,6083340,6086232,2892,"zString"
"23126",34,1,17,10,6093250,6096299,3049,"zString"
"24104",34,1,9,11,6100482,6102617,2135,"zString"
"26104",34,1,16,12,6110601,6114450,3849,"zString"
"2738",34,1,10,13,6117112,6119333,2221,"zString"
"2926",34,1,22,14,6124224,6126917,2693,"zString"
"3026",34,1,15,15,6133032,6136584,3552,"zString"
"3123",34,1,13,16,6139756,6143584,3828,"zString"
"3227",34,1,24,17,6146708,6150568,3860,"zString"
"3324",34,1,29,18,6154023,6157085,3062,"zString"
"3419",34,1,19,19,6159884,6163035,3151,"zString"
"3526",34,1,4,20,6165720,6169452,3732,"zString"
"3728",34,1,21,21,6177415,6180369,2954,"zString"
"3820",34,1,23,22,6183264,6186352,3088,"zString"
"3926",34,1,20,23,6188645,6193469,4824,"zString"
"4023",34,1,5,24,6196626,6199670,3044,"zString"
"4222",34,1,3,25,6206314,6209686,3372,"zString"
"4426",34,1,30,26,6215863,6220020,4157,"zString"
"4525",34,1,7,27,6223485,6228054,4569,"zString"
"4724",34,1,11,28,6234776,6237438,2662,"zString"
"4927",34,1,8,29,6242717,6247904,5187,"zString"
"5122",34,1,25,30,6255728,6258322,2594,"zString"
"5226",34,2,31,31,6262853,6267989,5136,"zString"
"5425",34,2,32,32,6274083,6277456,3373,"zString"
"5626",34,2,33,33,6282702,6285722,3020,"zString"
"5823",34,3,62,34,6290244,6293173,2929,"zString"
"6027",34,3,70,35,6299429,6302106,2677,"zString"
"6220",34,3,68,36,6308207,6312507,4300,"zString"
"6423",34,2,60,37,6316825,6320940,4115,"zString"
"6524",34,2,41,38,6324217,6327808,3591,"zString"
"6723",34,2,58,39,6332390,6335808,3418,"zString"
"6826",34,3,76,40,6338717,6342608,3891,"zString"
"6925",34,2,43,41,6345804,6350058,4254,"zString"
"7025",34,3,77,42,6479345,6482363,3018,"zString"
"7125",34,3,71,43,6484664,6488247,3583,"zString"
"7326",34,2,57,44,6493111,6495963,2852,"zString"
"7426",34,3,81,45,6499339,6502296,2957,"zString"
"7525",34,2,47,46,6507152,6510430,3278,"zString"
"7626",34,2,36,47,6512468,6515797,3329,"zString"
"7820",34,2,40,48,6522823,6526281,3458,"zString"
"8023",34,2,51,49,6537038,6541165,4127,"zString"
"8123",34,2,38,50,6544627,6548015,3388,"zString"
"8326",34,3,75,51,6552544,6556232,3688,"zString"
"8424",34,2,44,52,6558415,6561399,2984,"zString"
"8524",34,2,54,53,6563864,6567116,3252,"zString"
"8620",34,2,46,54,6569736,6573466,3730,"zString"
"8723",34,2,39,55,6575711,6579333,3622,"zString"
"8926",34,3,73,56,6586959,6589999,3040,"zString"
"9027",34,2,49,57,6593853,6596633,2780,"zString"
"9128",34,2,35,58,6600920,6603917,2997,"zString"
"9323",34,2,59,59,6609867,6613250,3383,"zString"
"9426",34,3,86,60,6618111,6621901,3790,"zString"
"9528",34,3,78,61,6629896,6633485,3589,"zString"
"9623",34,3,69,62,6639836,6642701,2865,"zString"
"9823",34,2,52,63,6648833,6652452,3619,"zString"
"9925",34,3,72,64,6657586,6660969,3383,"zString"
"10133",34,3,74,65,6665783,6669969,4186,"zString"
"10229",34,3,67,66,6674094,6677452,3358,"zString"
"10425",34,3,87,67,6682838,6686020,3182,"zString"
"10525",34,3,79,68,6689711,6693253,3542,"zString"
"10626",34,2,56,69,6695256,6699420,4164,"zString"
"10723",34,3,84,70,6702678,6706104,3426,"zString"
"10825",34,3,88,71,6709749,6713204,3455,"zString"
"10922",34,3,61,72,6716265,6720371,4106,"zString"
"11126",34,3,89,73,6726807,6730288,3481,"zString"
"11218",34,2,42,74,6732975,6735788,2813,"zString"
"11421",34,3,63,75,6740125,6744405,4280,"zString"
"11626",34,2,55,76,6749561,6752439,2878,"zString"
"11723",34,3,82,77,6755876,6759688,3812,"zString"
"11820",34,2,37,78,6761393,6764522,3129,"zString"
"12028",34,3,83,79,6770597,6773406,2809,"zString"
"12129",34,2,48,80,6775474,6780189,4715,"zString"
"12222",34,3,65,81,6782279,6785457,3178,"zString"
"12422",34,3,80,82,6789935,6793906,3971,"zString"
"12522",34,2,45,83,6796620,6800407,3787,"zString"
"12624",34,2,34,84,6802605,6807107,4502,"zString"
"12826",34,2,50,85,6813227,6816974,3747,"zString"
"12918",34,3,85,86,6820255,6824858,4603,"zString"
"13026",34,3,66,87,6832041,6835992,3951,"zString"
"13226",34,3,90,88,6843125,6846975,3850,"zString"
"13327",34,3,64,89,6851579,6855359,3780,"zString"
"13523",34,2,53,90,6860037,6863442,3405,"zString"
"14526",34,1,92,91,7177643,7181105,3462,"reading"
"14725",34,1,109,92,7187155,7190222,3067,"reading"
"14813",34,1,118,93,7192898,7196589,3691,"reading"
"14926",34,1,97,94,7200613,7202923,2310,"reading"
"15127",34,1,119,95,7209534,7213323,3789,"reading"
"15225",34,1,101,96,7218031,7220907,2876,"reading"
"15425",34,1,112,97,7226844,7229873,3029,"reading"
"15526",34,1,105,98,7233374,7236624,3250,"reading"
"15623",34,1,103,99,7240507,7244591,4084,"reading"
"15726",34,1,96,100,7248181,7251158,2977,"reading"
"15925",34,1,93,101,7258572,7263508,4936,"reading"
"16131",34,1,115,102,7268464,7271625,3161,"reading"
"16227",34,1,95,103,7275834,7279025,3191,"reading"
"16427",34,1,94,104,7286691,7290092,3401,"reading"
"16623",34,1,113,105,7295047,7297926,2879,"reading"
"16725",34,1,91,106,7301108,7304543,3435,"reading"
"16923",34,1,116,107,7314238,7317710,3472,"reading"
"17022",34,1,106,108,7320153,7323544,3391,"reading"
"17128",34,1,108,109,7331274,7334760,3486,"reading"
"17225",34,1,104,110,7338236,7340977,2741,"reading"
"17323",34,1,99,111,7344734,7347477,2743,"reading"
"17524",34,1,98,112,7354628,7359094,4466,"reading"
"17725",34,1,107,113,7366854,7372212,5358,"reading"
"17820",34,1,102,114,7375956,7379529,3573,"reading"
"18026",34,1,110,115,7385712,7388746,3034,"reading"
"18126",34,1,111,116,7391185,7394096,2911,"reading"
"18228",34,1,120,117,7396361,7399312,2951,"reading"
"18320",34,1,100,118,7401723,7404596,2873,"reading"
"18522",34,1,114,119,7412322,7415897,3575,"reading"
"18620",34,1,117,120,7418625,7421464,2839,"reading"
"18730",34,2,121,121,7426670,7430414,3744,"reading"
"18929",34,2,122,122,7438135,7441464,3329,"reading"
"19127",34,2,123,123,7448275,7452364,4089,"reading"
"19326",34,3,155,124,7458354,7464698,6344,"reading"
"19525",34,2,150,125,7471604,7474899,3295,"reading"
"19623",34,3,171,126,7479443,7482599,3156,"reading"
"19725",34,2,128,127,7488477,7491266,2789,"reading"
"19921",34,2,133,128,7499974,7503316,3342,"reading"
"20026",34,2,135,129,7509494,7512400,2906,"reading"
"20131",34,2,138,130,7516987,7520534,3547,"reading"
"20222",34,3,152,131,7523320,7527467,4147,"reading"
"20425",34,2,148,132,7951743,7955534,3791,"reading"
"20524",34,3,170,133,7957570,7960484,2914,"reading"
"20625",34,3,178,134,7962352,7965584,3232,"reading"
"20726",34,2,144,135,7968684,7972135,3451,"reading"
"20824",34,2,136,136,7974372,7977301,2929,"reading"
"20926",34,3,157,137,7979784,7983385,3601,"reading"
"21127",34,3,161,138,7988800,7992918,4118,"reading"
"21322",34,2,137,139,8001858,8004818,2960,"reading"
"21424",34,2,124,140,8007582,8011170,3588,"reading"
"21622",34,3,177,141,8017549,8022503,4954,"reading"
"21726",34,3,176,142,8027343,8030804,3461,"reading"
"21825",34,3,163,143,8033301,8036520,3219,"reading"
"21923",34,2,140,144,8038835,8042223,3388,"reading"
"22023",34,3,169,145,8044934,8048703,3769,"reading"
"22132",34,3,167,146,8051102,8054204,3102,"reading"
"22226",34,2,131,147,8056437,8059054,2617,"reading"
"22425",34,3,164,148,8065947,8069304,3357,"reading"
"22522",34,3,162,149,8072874,8075889,3015,"reading"
"22723",34,3,168,150,8081250,8084888,3638,"reading"
"22826",34,3,180,151,8088233,8092255,4022,"reading"
"22924",34,2,142,152,8096011,8099472,3461,"reading"
"23023",34,2,134,153,8102416,8105993,3577,"reading"
"23127",34,3,158,154,8108180,8111472,3292,"reading"
"23328",34,2,139,155,8117361,8120289,2928,"reading"
"23426",34,2,127,156,8125146,8127940,2794,"reading"
"23624",34,2,132,157,8134895,8137523,2628,"reading"
"23827",34,3,160,158,8143217,8146490,3273,"reading"
"24024",34,3,175,159,8153430,8155924,2494,"reading"
"24126",34,2,130,160,8157955,8161324,3369,"reading"
"24325",34,3,179,161,8166850,8169108,2258,"reading"
"24426",34,3,166,162,8171785,8175391,3606,"reading"
"24526",34,3,151,163,8179003,8182708,3705,"reading"
"24722",34,3,173,164,8188856,8192092,3236,"reading"
"24823",34,3,159,165,8194111,8197209,3098,"reading"
"25023",34,2,146,166,8204937,8208576,3639,"reading"
"25126",34,2,147,167,8211221,8214359,3138,"reading"
"25224",34,2,126,168,8221878,8225743,3865,"reading"
"25422",34,2,145,169,8233210,8237243,4033,"reading"
"25523",34,2,143,170,8239651,8242760,3109,"reading"
"25623",34,3,165,171,8244994,8248127,3133,"reading"
"25727",34,2,129,172,8251516,8254510,2994,"reading"
"25921",34,3,172,173,8261177,8264111,2934,"reading"
"26029",34,3,156,174,8266376,8270144,3768,"reading"
"26224",34,2,125,175,8278662,8282395,3733,"reading"
"26423",34,3,154,176,8287532,8289962,2430,"reading"
"26624",34,3,153,177,8297025,8299529,2504,"reading"
"26828",34,2,141,178,8305973,8308712,2739,"reading"
"26919",34,2,149,179,8313062,8315979,2917,"reading"
"27029",34,3,174,180,8320898,8323912,3014,"reading"
"10134",35,2,1,1,9374061,9379152,5091,"reading"
"12108",35,2,2,2,9384050,9388752,4702,"reading"
"1435",35,2,3,3,9394318,9397003,2685,"reading"
"16106",35,3,46,4,9401362,9404886,3524,"reading"
"17107",35,2,7,5,9407519,9410620,3101,"reading"
"19107",35,3,34,6,9417092,9420653,3561,"reading"
"21109",35,3,33,7,9425814,9429003,3189,"reading"
"23128",35,3,32,8,9433792,9436304,2512,"reading"
"25109",35,2,26,9,9442097,9444737,2640,"reading"
"26105",35,3,60,10,9447123,9449571,2448,"reading"
"2739",35,2,10,11,9451481,9453754,2273,"reading"
"2927",35,2,6,12,9459090,9461855,2765,"reading"
"3124",35,3,50,13,9467631,9470855,3224,"reading"
"3228",35,2,15,14,9473339,9475989,2650,"reading"
"3325",35,2,19,15,9477826,9481822,3996,"reading"
"3420",35,3,45,16,9484705,9488239,3534,"reading"
"3527",35,3,56,17,9490013,9492522,2509,"reading"
"3621",35,2,13,18,9494582,9497323,2741,"reading"
"3729",35,2,17,19,9499206,9502739,3533,"reading"
"3821",35,3,42,20,9505195,9509223,4028,"reading"
"4024",35,2,29,21,9516838,9520540,3702,"reading"
"4127",35,3,37,22,9522977,9527073,4096,"reading"
"4328",35,3,44,23,9532227,9534557,2330,"reading"
"4427",35,2,27,24,9537306,9540757,3451,"reading"
"4526",35,3,59,25,9543906,9546158,2252,"reading"
"4620",35,3,57,26,9548710,9552624,3914,"reading"
"4725",35,2,5,27,9555308,9558325,3017,"reading"
"4928",35,3,41,28,9564281,9566758,2477,"reading"
"5123",35,3,54,29,9571806,9574308,2502,"reading"
"5227",35,3,55,30,9577164,9579609,2445,"reading"
"5316",35,2,12,31,9581918,9585375,3457,"reading"
"5513",35,3,35,32,9591138,9592810,1672,"reading"
"5715",35,3,52,33,9598377,9601426,3049,"reading"
"5824",35,2,23,34,9603520,9606043,2523,"reading"
"5925",35,2,11,35,9607809,9610493,2684,"reading"
"6125",35,2,8,36,9616702,9619977,3275,"reading"
"6325",35,2,14,37,9625361,9627410,2049,"reading"
"6424",35,3,43,38,9629002,9631344,2342,"reading"
"6525",35,2,9,39,9634411,9636361,1950,"reading"
"6724",35,2,18,40,9640902,9643895,2993,"reading"
"6827",35,2,16,41,9646920,9649361,2441,"reading"
"6926",35,2,20,42,9727424,9730380,2956,"reading"
"7026",35,3,47,43,9732209,9736714,4505,"reading"
"7126",35,2,28,44,9738346,9740731,2385,"reading"
"7222",35,3,49,45,9743344,9745514,2170,"reading"
"7327",35,3,31,46,9747302,9750648,3346,"reading"
"7526",35,3,38,47,9756149,9758566,2417,"reading"
"7724",35,2,21,48,9764602,9769032,4430,"reading"
"7821",35,3,39,49,9771491,9774449,2958,"reading"
"8024",35,2,30,50,9779942,9783932,3990,"reading"
"8124",35,3,40,51,9786133,9788382,2249,"reading"
"8327",35,3,48,52,9794026,9796649,2623,"reading"
"8425",35,3,36,53,9798500,9801683,3183,"reading"
"8621",35,3,51,54,9808516,9814217,5701,"reading"
"8724",35,2,4,55,9816173,9819017,2844,"reading"
"8927",35,2,24,56,9825084,9828550,3466,"reading"
"9028",35,2,25,57,9830352,9832917,2565,"reading"
"9129",35,3,53,58,9835722,9840001,4279,"reading"
"9221",35,2,22,59,9842454,9844901,2447,"reading"
"9324",35,3,58,60,9846683,9849818,3135,"reading"
"9427",35,1,79,61,9852686,9855368,2682,"reading"
"9529",35,1,73,62,9858634,9861835,3201,"reading"
"9624",35,1,84,63,9864790,9867752,2962,"reading"
"9723",35,1,76,64,9869728,9871935,2207,"reading"
"9824",35,1,61,65,9875467,9878286,2819,"reading"
"10023",35,1,64,66,9883707,9887686,3979,"reading"
"10230",35,1,87,67,9896109,9899086,2977,"reading"
"10324",35,1,70,68,9900622,9903687,3065,"reading"
"10526",35,1,85,69,9909545,9913803,4258,"reading"
"10627",35,1,68,70,9916729,9919904,3175,"reading"
"10826",35,1,80,71,9925689,9930204,4515,"reading"
"10923",35,1,78,72,9931846,9934304,2458,"reading"
"11022",35,1,77,73,9937182,9940288,3106,"reading"
"11127",35,1,74,74,9942586,9945471,2885,"reading"
"11219",35,1,66,75,9948648,9951605,2957,"reading"
"11422",35,1,63,76,9957314,9963089,5775,"reading"
"11627",35,1,67,77,9967569,9969572,2003,"reading"
"11821",35,1,71,78,9976189,9978623,2434,"reading"
"12029",35,1,62,79,9982825,9986056,3231,"reading"
"12223",35,1,89,80,9991043,9993706,2663,"reading"
"12325",35,1,72,81,9996848,10000023,3175,"reading"
"12523",35,1,75,82,10004450,10007090,2640,"reading"
"12625",35,1,81,83,10009035,10014223,5188,"reading"
"12727",35,1,65,84,10017383,10020474,3091,"reading"
"12919",35,1,82,85,10026981,10032507,5526,"reading"
"13027",35,1,69,86,10034351,10037124,2773,"reading"
"13227",35,1,88,87,10042125,10045575,3450,"reading"
"13328",35,1,86,88,10050229,10054542,4313,"reading"
"13421",35,1,90,89,10056021,10058225,2204,"reading"
"13524",35,1,83,90,10059901,10062242,2341,"reading"
"14527",35,2,91,91,10247162,10250683,3521,"zString"
"14726",35,2,92,92,10254656,10258317,3661,"zString"
"14927",35,2,93,93,10263346,10265434,2088,"zString"
"15128",35,2,104,94,10270640,10273868,3228,"zString"
"15226",35,3,137,95,10275879,10278418,2539,"zString"
"15322",35,2,109,96,10279950,10282018,2068,"zString"
"15426",35,3,133,97,10284907,10287468,2561,"zString"
"15527",35,3,141,98,10290425,10293868,3443,"zString"
"15624",35,2,106,99,10296382,10299235,2853,"zString"
"15727",35,3,128,100,10302360,10305186,2826,"zString"
"15926",35,3,150,101,10310147,10313769,3622,"zString"
"16022",35,3,127,102,10315758,10318686,2928,"zString"
"16228",35,3,132,103,10322503,10325886,3383,"zString"
"16428",35,3,148,104,10330914,10335103,4189,"zString"
"16522",35,2,116,105,10336937,10343104,6167,"zString"
"16624",35,3,125,106,10346214,10350137,3923,"zString"
"16824",35,2,105,107,10355539,10357887,2348,"zString"
"16924",35,3,130,108,10359735,10363971,4236,"zString"
"17129",35,2,98,109,10369028,10372404,3376,"zString"
"17324",35,2,112,110,10376419,10379371,2952,"zString"
"17424",35,2,113,111,10382313,10384521,2208,"zString"
"17525",35,2,110,112,10387255,10390088,2833,"zString"
"17623",35,3,126,113,10393927,10397156,3229,"zString"
"17821",35,3,134,114,10402389,10405822,3433,"zString"
"17926",35,2,102,115,10408099,10410856,2757,"zString"
"18127",35,3,143,116,10421318,10424440,3122,"zString"
"18229",35,3,122,117,10426930,10430307,3377,"zString"
"18424",35,3,135,118,10434032,10437990,3958,"zString"
"18523",35,2,114,119,10440763,10443090,2327,"zString"
"18621",35,2,96,120,10446423,10449807,3384,"zString"
"18810",35,2,97,121,10454976,10457491,2515,"zString"
"19017",35,3,147,122,10461991,10465691,3700,"zString"
"19128",35,2,107,123,10468246,10471491,3245,"zString"
"19220",35,3,146,124,10473460,10477091,3631,"zString"
"19327",35,2,111,125,10480569,10483175,2606,"zString"
"19423",35,3,136,126,10485026,10488625,3599,"zString"
"19526",35,2,103,127,10491829,10496309,4480,"zString"
"19624",35,3,131,128,10499570,10503042,3472,"zString"
"19824",35,3,140,129,10506979,10512376,5397,"zString"
"19922",35,2,119,130,10514151,10517526,3375,"zString"
"20027",35,3,124,131,10521027,10524560,3533,"zString"
"20223",35,3,121,132,10648249,10650531,2282,"zString"
"20426",35,3,129,133,10654561,10657414,2853,"zString"
"20626",35,2,120,134,10664252,10667348,3096,"zString"
"20727",35,3,142,135,10669044,10671798,2754,"zString"
"20825",35,2,108,136,10674523,10677782,3259,"zString"
"20927",35,3,144,137,10680519,10683615,3096,"zString"
"21026",35,3,149,138,10686619,10690332,3713,"zString"
"21128",35,2,101,139,10691996,10695366,3370,"zString"
"21323",35,2,118,140,10699954,10703916,3962,"zString"
"21425",35,2,95,141,10705617,10709183,3566,"zString"
"21623",35,3,123,142,10714241,10717416,3175,"zString"
"21826",35,3,145,143,10721897,10724750,2853,"zString"
"21924",35,2,115,144,10726262,10729183,2921,"zString"
"22024",35,2,94,145,10732592,10735600,3008,"zString"
"22227",35,3,138,146,10739681,10742434,2753,"zString"
"22326",35,3,139,147,10744343,10748500,4157,"zString"
"22426",35,2,117,148,10751079,10753368,2289,"zString"
"22523",35,2,100,149,10756823,10760101,3278,"zString"
"22724",35,2,99,150,10764256,10768185,3929,"zString"
"22925",35,1,173,151,10773189,10775985,2796,"zString"
"23024",35,1,170,152,10780103,10783018,2915,"zString"
"23129",35,1,180,153,10785193,10788669,3476,"zString"
"23222",35,1,176,154,10790268,10794585,4317,"zString"
"23329",35,1,175,155,10796371,10799402,3031,"zString"
"23427",35,1,168,156,10801484,10804953,3469,"zString"
"23524",35,1,160,157,10806581,10809936,3355,"zString"
"23722",35,1,156,158,10815464,10819103,3639,"zString"
"23921",35,1,178,159,10823192,10825537,2345,"zString"
"24025",35,1,172,160,10827921,10831587,3666,"zString"
"24127",35,1,166,161,10833402,10836504,3102,"zString"
"24224",35,1,169,162,10838052,10841504,3452,"zString"
"24326",35,1,151,163,10844264,10847854,3590,"zString"
"24527",35,1,174,164,10853060,10857721,4661,"zString"
"24624",35,1,155,165,10859556,10863371,3815,"zString"
"24824",35,1,164,166,10867195,10870772,3577,"zString"
"24924",35,1,171,167,10873475,10878905,5430,"zString"
"25024",35,1,161,168,10880506,10884839,4333,"zString"
"25225",35,1,163,169,10889018,10893856,4838,"zString"
"25324",35,1,153,170,10895575,10898873,3298,"zString"
"25524",35,1,165,171,10903943,10907523,3580,"zString"
"25624",35,1,152,172,10909142,10913023,3881,"zString"
"25824",35,1,157,173,10917511,10921156,3645,"zString"
"26030",35,1,162,174,10924831,10928190,3359,"zString"
"26225",35,1,179,175,10933313,10939007,5694,"zString"
"26325",35,1,177,176,10940939,10947208,6269,"zString"
"26424",35,1,158,177,10949320,10952258,2938,"zString"
"26625",35,1,154,178,10957942,10962408,4466,"zString"
"26829",35,1,167,179,10966380,10970358,3978,"zString"
"26920",35,1,159,180,10972139,10976275,4136,"zString"
"10135",36,2,61,1,1515758,1528779,13021,"zString"
"12109",36,2,62,2,1533500,1544912,11412,"zString"
"1436",36,2,63,3,1551270,1562846,11576,"zString"
"16107",36,2,83,4,1567906,1580247,12341,"zString"
"17108",36,3,17,5,1584853,1595830,10977,"zString"
"18105",36,3,24,6,1598735,1608797,10062,"zString"
"19108",36,2,81,7,1612750,1621381,8631,"zString"
"20103",36,3,19,8,1623841,1637065,13224,"zString"
"21129",36,3,12,9,1640594,1649316,8722,"zString"
"23130",36,2,77,10,1654288,1659716,5428,"zString"
"24105",36,3,20,11,1661946,1671850,9904,"zString"
"25127",36,3,14,12,1674455,1682417,7962,"zString"
"26106",36,2,78,13,1685482,1694268,8786,"zString"
"2740",36,2,73,14,1698614,1704567,5953,"zString"
"2819",36,3,27,15,1708158,1717601,9443,"zString"
"2928",36,2,64,16,1721413,1732985,11572,"zString"
"3125",36,3,3,17,1738399,1747086,8687,"zString"
"3326",36,2,90,18,1751529,1759203,7674,"zString"
"3421",36,3,18,19,1762107,1768486,6379,"zString"
"3528",36,3,25,20,1771890,1779737,7847,"zString"
"3622",36,3,4,21,1782078,1795921,13843,"zString"
"3822",36,2,88,22,1801094,1812654,11560,"zString"
"3927",36,2,70,23,1815509,1826489,10980,"zString"
"4128",36,3,10,24,1833037,1840939,7902,"zString"
"4329",36,3,1,25,1845229,1854706,9477,"zString"
"4527",36,3,13,26,1858677,1870623,11946,"zString"
"4621",36,3,16,27,1873246,1887524,14278,"zString"
"4726",36,2,75,28,1890479,1900941,10462,"zString"
"4821",36,2,65,29,1907110,1916075,8965,"zString"
"5022",36,3,22,30,1922664,1933209,10545,"zString"
"5124",36,3,28,31,1936957,1952709,15752,"zString"
"5228",36,2,79,32,1957402,1968693,11291,"zString"
"5317",36,3,2,33,1973876,1986544,12668,"zString"
"5514",36,2,69,34,1991159,2004611,13452,"zString"
"5716",36,3,29,35,2009689,2020729,11040,"zString"
"5825",36,2,72,36,2023687,2039129,15442,"zString"
"6028",36,2,89,37,2043226,2051446,8220,"zString"
"6126",36,3,11,38,2054226,2067013,12787,"zString"
"6326",36,2,85,39,2075076,2086214,11138,"zString"
"6425",36,3,5,40,2088146,2096398,8252,"zString"
"6624",36,2,76,41,2101140,2110182,9042,"zString"
"6725",36,2,66,42,2258907,2268804,9897,"zString"
"6927",36,3,30,43,2274411,2282538,8127,"zString"
"7027",36,3,26,44,2285165,2293538,8373,"zString"
"7127",36,2,74,45,2295975,2303922,7947,"zString"
"7223",36,2,68,46,2305889,2315805,9916,"zString"
"7427",36,3,21,47,2320753,2332022,11269,"zString"
"7527",36,3,23,48,2334117,2347289,13172,"zString"
"7627",36,3,9,49,2352626,2359607,6981,"zString"
"7822",36,2,86,50,2364223,2369524,5301,"zString"
"7928",36,2,80,51,2371826,2378907,7081,"zString"
"8025",36,2,71,52,2381265,2388308,7043,"zString"
"8224",36,3,7,53,2393149,2399641,6492,"zString"
"8426",36,3,6,54,2403926,2408092,4166,"zString"
"8622",36,2,84,55,2413016,2419109,6093,"zString"
"8725",36,2,87,56,2421593,2429326,7733,"zString"
"8824",36,3,8,57,2432391,2442043,9652,"zString"
"9029",36,2,67,58,2450058,2457444,7386,"zString"
"9222",36,2,82,59,2461233,2468460,7227,"zString"
"9325",36,3,15,60,2470284,2477044,6760,"zString"
"9428",36,1,49,61,2479361,2487194,7833,"zString"
"9530",36,1,44,62,2488976,2495778,6802,"zString"
"9625",36,1,39,63,2498189,2511728,13539,"zString"
"9825",36,1,42,64,2515689,2522096,6407,"zString"
"10024",36,1,36,65,2526056,2537013,10957,"zString"
"10231",36,1,32,66,2540680,2546780,6100,"zString"
"10426",36,1,34,67,2551029,2558997,7968,"zString"
"10628",36,1,54,68,2562789,2567881,5092,"zString"
"10724",36,1,50,69,2570875,2578764,7889,"zString"
"10827",36,1,55,70,2584681,2592881,8200,"zString"
"10924",36,1,43,71,2594798,2600798,6000,"zString"
"11023",36,1,41,72,2603146,2607665,4519,"zString"
"11220",36,1,38,73,2611592,2617065,5473,"zString"
"11423",36,1,53,74,2621956,2625849,3893,"zString"
"11519",36,1,40,75,2628063,2634350,6287,"zString"
"11724",36,1,47,76,2639969,2647900,7931,"zString"
"11822",36,1,52,77,2649711,2658133,8422,"zString"
"11923",36,1,59,78,2661507,2668451,6944,"zString"
"12030",36,1,37,79,2670596,2674950,4354,"zString"
"12224",36,1,35,80,2679831,2685834,6003,"zString"
"12423",36,1,46,81,2690122,2697735,7613,"zString"
"12524",36,1,51,82,2700508,2709269,8761,"zString"
"12626",36,1,31,83,2711263,2718802,7539,"zString"
"12827",36,1,33,84,2722770,2727469,4699,"zString"
"13028",36,1,57,85,2731742,2736953,5211,"zString"
"13120",36,1,48,86,2739241,2747103,7862,"zString"
"13228",36,1,56,87,2749738,2757287,7549,"zString"
"13329",36,1,60,88,2759056,2769704,10648,"zString"
"13422",36,1,58,89,2775275,2782188,6913,"zString"
"13525",36,1,45,90,2784405,2790121,5716,"zString"
"14528",36,2,151,91,2958598,2964029,5431,"reading"
"14727",36,2,152,92,2970665,2982380,11715,"reading"
"14928",36,2,153,93,2987964,2992613,4649,"reading"
"15129",36,2,167,94,2997158,3003497,6339,"reading"
"15227",36,2,160,95,3005956,3010214,4258,"reading"
"15427",36,3,101,96,3016687,3022931,6244,"reading"
"15625",36,3,111,97,3030518,3037515,6997,"reading"
"15728",36,3,105,98,3039791,3045065,5274,"reading"
"15820",36,3,110,99,3047170,3051532,4362,"reading"
"15927",36,2,166,100,3055503,3063566,8063,"reading"
"16023",36,2,157,101,3066074,3070800,4726,"reading"
"16229",36,2,179,102,3076630,3080900,4270,"reading"
"16322",36,2,180,103,3084057,3092083,8026,"reading"
"16429",36,3,119,104,3094299,3099567,5268,"reading"
"16523",36,3,93,105,3101236,3105118,3882,"reading"
"16726",36,2,156,106,3109863,3117251,7388,"reading"
"16925",36,3,109,107,3123361,3126501,3140,"reading"
"17023",36,2,154,108,3132086,3135485,3399,"reading"
"17226",36,2,172,109,3140235,3145669,5434,"reading"
"17325",36,2,169,110,3149958,3159803,9845,"reading"
"17425",36,3,91,111,3162372,3168803,6431,"reading"
"17624",36,2,163,112,3176234,3181970,5736,"reading"
"17726",36,3,104,113,3183540,3186787,3247,"reading"
"17822",36,2,159,114,3188931,3193338,4407,"reading"
"18027",36,3,102,115,3199186,3202688,3502,"reading"
"18230",36,2,173,116,3208587,3216121,7534,"reading"
"18321",36,2,161,117,3217877,3226222,8345,"reading"
"18524",36,3,118,118,3232929,3237156,4227,"reading"
"18622",36,2,158,119,3239646,3246589,6943,"reading"
"18811",36,3,108,120,3250975,3254372,3397,"reading"
"18930",36,3,106,121,3256573,3267706,11133,"reading"
"19018",36,3,117,122,3270885,3274340,3455,"reading"
"19129",36,2,168,123,3276436,3282757,6321,"reading"
"19221",36,2,177,124,3284310,3291474,7164,"reading"
"19328",36,3,96,125,3295054,3298324,3270,"reading"
"19527",36,3,116,126,3303496,3306524,3028,"reading"
"19625",36,3,103,127,3308592,3316041,7449,"reading"
"19726",36,2,162,128,3317488,3321541,4053,"reading"
"19923",36,2,178,129,3326353,3333859,7506,"reading"
"20028",36,3,97,130,3338687,3342175,3488,"reading"
"20224",36,3,94,131,3347054,3351692,4638,"reading"
"20427",36,2,155,132,3393210,3403461,10251,"reading"
"20627",36,3,120,133,3409379,3417978,8599,"reading"
"20728",36,3,100,134,3422670,3427228,4558,"reading"
"20928",36,2,170,135,3434539,3438896,4357,"reading"
"21027",36,2,171,136,3441018,3448613,7595,"reading"
"21130",36,3,92,137,3453902,3459596,5694,"reading"
"21324",36,3,98,138,3464881,3469030,4149,"reading"
"21525",36,3,99,139,3473642,3478797,5155,"reading"
"21727",36,3,115,140,3484426,3490447,6021,"reading"
"21827",36,2,164,141,3493602,3498714,5112,"reading"
"21925",36,3,112,142,3500571,3507414,6843,"reading"
"22025",36,2,176,143,3509153,3515264,6111,"reading"
"22133",36,3,107,144,3517121,3520265,3144,"reading"
"22228",36,2,174,145,3522042,3525766,3724,"reading"
"22327",36,2,165,146,3527508,3531999,4491,"reading"
"22427",36,3,113,147,3533602,3536782,3180,"reading"
"22524",36,3,95,148,3538635,3541782,3147,"reading"
"22725",36,3,114,149,3547468,3550882,3414,"reading"
"22827",36,2,175,150,3552806,3556416,3610,"reading"
"22926",36,1,132,151,3558435,3562099,3664,"reading"
"23131",36,1,143,152,3568144,3572917,4773,"reading"
"23223",36,1,147,153,3575286,3583184,7898,"reading"
"23330",36,1,124,154,3585404,3591351,5947,"reading"
"23525",36,1,138,155,3597006,3601368,4362,"reading"
"23625",36,1,141,156,3606171,3610418,4247,"reading"
"23723",36,1,142,157,3613987,3621785,7798,"reading"
"23828",36,1,121,158,3625698,3629869,4171,"reading"
"24026",36,1,139,159,3634578,3637355,2777,"reading"
"24128",36,1,125,160,3640910,3644770,3860,"reading"
"24327",36,1,126,161,3650450,3654269,3819,"reading"
"24528",36,1,135,162,3658979,3663103,4124,"reading"
"24625",36,1,127,163,3665955,3669453,3498,"reading"
"24825",36,1,144,164,3678185,3682104,3919,"reading"
"24925",36,1,131,165,3687223,3692604,5381,"reading"
"25128",36,1,122,166,3702316,3709004,6688,"reading"
"25325",36,1,149,167,3718808,3725055,6247,"reading"
"25423",36,1,134,168,3727027,3732172,5145,"reading"
"25525",36,1,133,169,3734723,3738622,3899,"reading"
"25625",36,1,137,170,3741536,3744573,3037,"reading"
"25728",36,1,146,171,3746985,3750673,3688,"reading"
"25825",36,1,150,172,3752681,3756073,3392,"reading"
"25922",36,1,123,173,3763785,3767440,3655,"reading"
"26127",36,1,145,174,3773529,3776740,3211,"reading"
"26226",36,1,148,175,3778901,3783324,4423,"reading"
"26326",36,1,129,176,3785578,3788774,3196,"reading"
"26523",36,1,128,177,3793842,3796941,3099,"reading"
"26722",36,1,130,178,3802094,3805608,3514,"reading"
"26921",36,1,140,179,3810061,3812775,2714,"reading"
"27030",36,1,136,180,3814495,3817642,3147,"reading"
"10136",37,1,4,1,5614209,5620320,6111,"reading"
"12130",37,1,15,2,5627091,5633653,6562,"reading"
"1368",37,1,20,3,5636577,5641154,4577,"reading"
"1437",37,1,2,4,5643981,5650087,6106,"reading"
"16108",37,1,23,5,5657004,5662421,5417,"reading"
"17109",37,1,8,6,5666010,5673721,7711,"reading"
"19109",37,1,30,7,5679084,5683322,4238,"reading"
"20104",37,1,6,8,5685649,5690639,4990,"reading"
"22134",37,1,18,9,5697144,5703956,6812,"reading"
"23132",37,1,10,10,5707180,5710939,3759,"reading"
"25129",37,1,29,11,5716551,5725273,8722,"reading"
"26107",37,1,9,12,5727529,5731390,3861,"reading"
"2820",37,1,25,13,5737908,5742374,4466,"reading"
"2929",37,1,5,14,5746414,5754124,7710,"reading"
"3126",37,1,14,15,5761699,5766191,4492,"reading"
"3229",37,1,11,16,5769071,5773592,4521,"reading"
"3422",37,1,17,17,5781486,5787842,6356,"reading"
"3529",37,1,24,18,5789852,5799076,9224,"reading"
"3623",37,1,13,19,5801182,5808359,7177,"reading"
"3730",37,1,19,20,5810838,5816310,5472,"reading"
"3823",37,1,7,21,5819198,5826527,7329,"reading"
"4025",37,1,16,22,5834853,5839877,5024,"reading"
"4129",37,1,28,23,5841909,5847627,5718,"reading"
"4223",37,1,1,24,5851160,5861895,10735,"reading"
"4428",37,1,21,25,5868897,5874212,5315,"reading"
"4528",37,1,22,26,5876763,5882162,5399,"reading"
"4622",37,1,26,27,5884520,5888895,4375,"reading"
"4727",37,1,27,28,5892550,5903129,10579,"reading"
"4822",37,1,3,29,5905825,5909179,3354,"reading"
"5023",37,1,12,30,5914564,5921230,6666,"reading"
"5229",37,2,31,31,5927221,5936014,8793,"reading"
"5426",37,2,32,32,5941256,5946981,5725,"reading"
"5627",37,2,33,33,5954214,5962165,7951,"reading"
"5826",37,3,69,34,5967916,5972699,4783,"reading"
"6029",37,3,64,35,5978432,5984432,6000,"reading"
"6221",37,3,85,36,5992262,5997649,5387,"reading"
"6327",37,2,44,37,5999871,6003099,3228,"reading"
"6426",37,2,58,38,6005838,6012066,6228,"reading"
"6526",37,2,50,39,6016097,6019834,3737,"reading"
"6625",37,2,35,40,6022117,6025184,3067,"reading"
"6828",37,2,57,41,6031942,6036184,4242,"reading"
"6928",37,2,53,42,6067373,6071768,4395,"reading"
"7028",37,3,82,43,6073764,6081002,7238,"reading"
"7128",37,3,77,44,6082841,6086319,3478,"reading"
"7224",37,3,81,45,6089063,6093635,4572,"reading"
"7328",37,2,55,46,6096894,6100603,3709,"reading"
"7428",37,3,89,47,6102878,6108069,5191,"reading"
"7528",37,3,63,48,6110452,6118220,7768,"reading"
"7725",37,3,88,49,6123277,6127820,4543,"reading"
"7823",37,2,45,50,6130058,6135071,5013,"reading"
"7929",37,3,68,51,6139121,6143321,4200,"reading"
"8125",37,2,37,52,6150076,6155471,5395,"reading"
"8328",37,3,73,53,6160648,6165155,4507,"reading"
"8427",37,2,49,54,6167430,6172905,5475,"reading"
"8525",37,3,67,55,6175460,6179906,4446,"reading"
"8726",37,2,56,56,6185323,6190222,4899,"reading"
"8825",37,3,80,57,6192196,6199806,7610,"reading"
"8928",37,3,65,58,6202213,6206440,4227,"reading"
"9130",37,3,61,59,6212958,6218107,5149,"reading"
"9326",37,3,90,60,6223505,6228124,4619,"reading"
"9429",37,2,40,61,6230431,6236440,6009,"reading"
"9626",37,3,76,62,6241713,6244524,2811,"reading"
"9724",37,3,83,63,6246507,6251108,4601,"reading"
"9826",37,2,48,64,6253100,6258725,5625,"reading"
"9926",37,3,74,65,6263105,6268425,5320,"reading"
"10025",37,3,75,66,6272459,6278792,6333,"reading"
"10137",37,3,78,67,6281832,6287892,6060,"reading"
"10232",37,2,52,68,6290219,6297009,6790,"reading"
"10325",37,2,38,69,6298986,6303093,4107,"reading"
"10527",37,3,72,70,6308662,6313027,4365,"reading"
"10725",37,2,41,71,6319392,6322693,3301,"reading"
"10925",37,2,43,72,6328104,6332594,4490,"reading"
"11024",37,3,86,73,6334548,6339427,4879,"reading"
"11128",37,2,47,74,6341187,6347644,6457,"reading"
"11221",37,2,42,75,6349580,6353678,4098,"reading"
"11424",37,2,54,76,6361472,6366712,5240,"reading"
"11520",37,2,36,77,6368801,6371428,2627,"reading"
"11725",37,3,66,78,6378043,6381979,3936,"reading"
"11924",37,2,51,79,6387954,6394946,6992,"reading"
"12031",37,3,70,80,6397301,6401296,3995,"reading"
"12225",37,3,62,81,6407421,6410530,3109,"reading"
"12424",37,2,46,82,6415926,6421964,6038,"reading"
"12525",37,2,59,83,6425911,6429630,3719,"reading"
"12627",37,2,60,84,6431969,6437564,5595,"reading"
"12728",37,3,71,85,6440030,6444048,4018,"reading"
"12920",37,3,84,86,6449337,6454831,5494,"reading"
"13029",37,2,39,87,6456818,6463515,6697,"reading"
"13229",37,3,79,88,6469515,6475382,5867,"reading"
"13330",37,3,87,89,6477825,6482666,4841,"reading"
"13423",37,2,34,90,6485561,6489416,3855,"reading"
"14529",37,1,92,91,6598794,6603371,4577,"zString"
"14728",37,1,104,92,6607809,6612572,4763,"zString"
"14814",37,1,96,93,6615601,6619255,3654,"zString"
"15015",37,1,112,94,6625230,6628788,3558,"zString"
"15130",37,1,113,95,6631728,6634672,2944,"zString"
"15228",37,1,98,96,6637844,6641539,3695,"zString"
"15428",37,1,110,97,6646263,6649406,3143,"zString"
"15528",37,1,94,98,6651384,6653923,2539,"zString"
"15729",37,1,93,99,6659189,6661506,2317,"zString"
"15928",37,1,106,100,6666430,6669974,3544,"zString"
"16024",37,1,109,101,6673222,6675624,2402,"zString"
"16132",37,1,99,102,6678062,6681090,3028,"zString"
"16323",37,1,111,103,6686347,6689974,3627,"zString"
"16430",37,1,107,104,6694446,6697091,2645,"zString"
"16524",37,1,108,105,6699189,6702825,3636,"zString"
"16625",37,1,117,106,6706633,6710008,3375,"zString"
"16727",37,1,103,107,6713496,6716758,3262,"zString"
"16825",37,1,95,108,6718817,6723092,4275,"zString"
"17024",37,1,120,109,6729610,6733692,4082,"zString"
"17130",37,1,115,110,6736074,6739276,3202,"zString"
"17227",37,1,97,111,6743283,6746692,3409,"zString"
"17426",37,1,105,112,6751272,6754676,3404,"zString"
"17526",37,1,114,113,6757226,6762360,5134,"zString"
"17625",37,1,116,114,6765382,6770026,4644,"zString"
"17727",37,1,102,115,6772549,6775677,3128,"zString"
"17927",37,1,100,116,6780163,6785144,4981,"zString"
"18128",37,1,91,117,6789284,6793361,4077,"zString"
"18322",37,1,101,118,6797021,6800645,3624,"zString"
"18525",37,1,118,119,6804833,6807595,2762,"zString"
"18623",37,1,119,120,6809198,6812795,3597,"zString"
"18731",37,2,121,121,6817483,6820678,3195,"zString"
"18931",37,2,122,122,6825067,6828679,3612,"zString"
"19130",37,2,123,123,6834462,6838512,4050,"zString"
"19329",37,2,139,124,6842674,6846929,4255,"zString"
"19424",37,3,179,125,6849887,6854046,4159,"zString"
"19528",37,3,178,126,6856699,6860480,3781,"zString"
"19626",37,2,142,127,6864233,6868163,3930,"zString"
"19727",37,2,148,128,6870779,6876113,5334,"zString"
"19825",37,3,175,129,6879233,6883130,3897,"zString"
"19924",37,2,134,130,6887648,6891647,3999,"zString"
"20029",37,3,155,131,6893937,6897765,3828,"zString"
"20225",37,3,154,132,6966438,6970367,3929,"zString"
"20428",37,3,159,133,6974895,6978484,3589,"zString"
"20628",37,2,140,134,6983793,6987634,3841,"zString"
"20729",37,2,133,135,6991300,6994551,3251,"zString"
"20826",37,2,127,136,6996464,6999868,3404,"zString"
"21028",37,2,144,137,7004521,7009036,4515,"zString"
"21131",37,3,152,138,7011650,7016518,4868,"zString"
"21325",37,3,158,139,7020959,7024986,4027,"zString"
"21526",37,3,156,140,7029516,7033319,3803,"zString"
"21728",37,2,126,141,7038012,7042536,4524,"zString"
"21926",37,2,147,142,7048417,7052353,3936,"zString"
"22026",37,3,170,143,7055610,7059270,3660,"zString"
"22135",37,2,132,144,7062872,7066887,4015,"zString"
"22328",37,2,143,145,7071490,7074870,3380,"zString"
"22428",37,2,124,146,7076958,7081720,4762,"zString"
"22622",37,2,129,147,7087324,7090088,2764,"zString"
"22828",37,3,162,148,7094897,7098004,3107,"zString"
"23025",37,2,145,149,7103232,7105938,2706,"zString"
"23133",37,3,161,150,7109684,7112922,3238,"zString"
"23331",37,3,163,151,7118852,7122305,3453,"zString"
"23428",37,2,131,152,7124402,7128089,3687,"zString"
"23626",37,3,160,153,7134447,7139589,5142,"zString"
"23829",37,3,171,154,7143887,7148123,4236,"zString"
"23922",37,3,157,155,7151270,7155323,4053,"zString"
"24129",37,3,165,156,7160028,7164257,4229,"zString"
"24225",37,2,137,157,7167857,7172607,4750,"zString"
"24328",37,3,180,158,7176775,7181241,4466,"zString"
"24427",37,3,167,159,7184263,7188774,4511,"zString"
"24529",37,2,150,160,7192312,7196624,4312,"zString"
"24626",37,3,176,161,7199654,7203525,3871,"zString"
"24723",37,3,169,162,7207578,7211875,4297,"zString"
"24826",37,2,130,163,7215572,7219725,4153,"zString"
"25025",37,3,166,164,7225380,7229942,4562,"zString"
"25130",37,2,128,165,7239427,7244043,4616,"zString"
"25326",37,3,168,166,7248904,7252843,3939,"zString"
"25424",37,2,149,167,7258160,7261576,3416,"zString"
"25526",37,3,174,168,7265278,7269827,4549,"zString"
"25626",37,2,135,169,7271915,7276627,4712,"zString"
"25729",37,3,164,170,7279318,7283011,3693,"zString"
"25826",37,2,138,171,7284642,7288594,3952,"zString"
"25923",37,3,153,172,7291648,7294878,3230,"zString"
"26128",37,2,141,173,7300119,7303411,3292,"zString"
"26227",37,3,172,174,7305287,7309295,4008,"zString"
"26327",37,3,151,175,7311240,7315395,4155,"zString"
"26524",37,2,146,176,7319587,7324329,4742,"zString"
"26626",37,2,136,177,7327471,7332229,4758,"zString"
"26723",37,3,173,178,7337430,7341463,4033,"zString"
"26830",37,2,125,179,7344400,7348413,4013,"zString"
"27031",37,3,177,180,7353766,7358197,4431,"zString"
"10138",38,1,89,1,8315417,8317816,2399,"zString"
"1170",38,1,81,2,8319685,8323782,4097,"zString"
"12131",38,1,79,3,8325708,8329283,3575,"zString"
"1369",38,1,71,4,8330974,8334950,3976,"zString"
"15101",38,1,62,5,8339373,8342300,2927,"zString"
"17131",38,1,68,6,8346758,8351667,4909,"zString"
"19131",38,1,77,7,8356637,8361000,4363,"zString"
"20105",38,1,85,8,8365342,8369417,4075,"zString"
"21132",38,1,65,9,8373817,8378567,4750,"zString"
"23134",38,1,88,10,8382439,8386718,4279,"zString"
"24106",38,1,70,11,8388452,8391568,3116,"zString"
"26108",38,1,73,12,8395207,8398435,3228,"zString"
"2744",38,1,72,13,8400587,8406152,5565,"zString"
"2930",38,1,87,14,8410011,8413918,3907,"zString"
"3027",38,1,83,15,8415752,8420185,4433,"zString"
"3127",38,1,84,16,8421904,8425653,3749,"zString"
"3230",38,1,90,17,8427467,8430986,3519,"zString"
"3327",38,1,86,18,8432957,8438836,5879,"zString"
"3423",38,1,76,19,8441370,8444870,3500,"zString"
"3530",38,1,67,20,8446650,8449587,2937,"zString"
"3731",38,1,82,21,8453423,8457420,3997,"zString"
"3824",38,1,64,22,8459269,8463854,4585,"zString"
"4026",38,1,63,23,8467599,8470521,2922,"zString"
"4224",38,1,74,24,8475041,8479288,4247,"zString"
"4330",38,1,61,25,8480958,8484688,3730,"zString"
"4529",38,1,80,26,8488384,8494805,6421,"zString"
"4623",38,1,78,27,8496191,8500105,3914,"zString"
"4728",38,1,69,28,8501957,8504989,3032,"zString"
"4929",38,1,75,29,8508900,8514405,5505,"zString"
"5024",38,1,66,30,8516822,8520222,3400,"zString"
"5230",38,2,1,31,8523675,8529373,5698,"zString"
"5427",38,2,2,32,8533551,8539240,5689,"zString"
"5628",38,2,3,33,8543093,8545890,2797,"zString"
"5827",38,3,47,34,8549665,8554207,4542,"zString"
"5926",38,2,9,35,8556101,8559690,3589,"zString"
"6127",38,3,52,36,8563280,8567008,3728,"zString"
"6222",38,3,50,37,8568405,8573991,5586,"zString"
"6328",38,3,56,38,8575833,8579625,3792,"zString"
"6427",38,3,32,39,8581348,8584475,3127,"zString"
"6626",38,3,59,40,8588277,8591242,2965,"zString"
"6726",38,3,31,41,8592833,8596492,3659,"zString"
"6929",38,3,34,42,8646595,8650744,4149,"zString"
"7129",38,2,30,43,8654890,8657610,2720,"zString"
"7225",38,2,18,44,8659680,8662344,2664,"zString"
"7329",38,2,6,45,8663809,8666394,2585,"zString"
"7529",38,2,4,46,8670494,8675011,4517,"zString"
"7726",38,2,28,47,8678465,8682728,4263,"zString"
"7824",38,2,15,48,8684278,8687895,3617,"zString"
"7930",38,2,14,49,8690340,8693712,3372,"zString"
"8026",38,2,24,50,8695708,8699128,3420,"zString"
"8126",38,3,48,51,8700735,8705112,4377,"zString"
"8225",38,3,46,52,8707172,8711395,4223,"zString"
"8329",38,2,16,53,8713385,8717196,3811,"zString"
"8428",38,3,33,54,8719384,8722980,3596,"zString"
"8623",38,3,40,55,8730689,8733830,3141,"zString"
"8826",38,2,27,56,8737647,8742446,4799,"zString"
"8929",38,2,26,57,8744808,8748147,3339,"zString"
"9030",38,2,8,58,8749740,8752447,2707,"zString"
"9223",38,2,17,59,8756176,8759797,3621,"zString"
"9327",38,3,49,60,8761665,8764364,2699,"zString"
"9430",38,2,25,61,8766392,8769198,2806,"zString"
"9531",38,2,21,62,8770655,8773798,3143,"zString"
"9627",38,3,42,63,8775212,8782615,7403,"zString"
"9827",38,2,12,64,8787671,8790482,2811,"zString"
"10026",38,3,60,65,8794118,8797882,3764,"zString"
"10139",38,2,11,66,8799501,8803899,4398,"zString"
"10326",38,2,5,67,8807188,8811316,4128,"zString"
"10528",38,3,39,68,8815352,8818883,3531,"zString"
"10726",38,2,23,69,8822883,8826449,3566,"zString"
"10828",38,3,36,70,8827962,8832083,4121,"zString"
"11025",38,3,53,71,8835862,8839000,3138,"zString"
"11129",38,3,35,72,8842936,8847367,4431,"zString"
"11328",38,2,19,73,8850946,8854734,3788,"zString"
"11425",38,3,41,74,8856820,8860234,3414,"zString"
"11628",38,3,43,75,8864471,8868451,3980,"zString"
"11726",38,3,58,76,8869987,8873168,3181,"zString"
"11823",38,3,54,77,8874904,8877551,2647,"zString"
"11925",38,2,29,78,8878813,8881485,2672,"zString"
"12032",38,2,20,79,8882909,8887269,4360,"zString"
"12132",38,2,10,80,8889026,8892002,2976,"zString"
"12326",38,3,51,81,8895954,8900552,4598,"zString"
"12425",38,2,7,82,8902256,8906902,4646,"zString"
"12628",38,3,38,83,8910765,8916003,5238,"zString"
"12828",38,3,37,84,8920772,8923069,2297,"zString"
"13030",38,3,44,85,8926614,8929337,2723,"zString"
"13121",38,2,22,86,8931157,8934820,3663,"zString"
"13230",38,2,13,87,8936273,8940237,3964,"zString"
"13331",38,3,45,88,8941565,8946304,4739,"zString"
"13424",38,3,55,89,8948068,8950804,2736,"zString"
"13526",38,3,57,90,8952281,8958604,6323,"zString"
"14530",38,1,176,91,9027934,9031125,3191,"reading"
"1469",38,1,180,92,9032915,9036042,3127,"reading"
"14729",38,1,163,93,9037825,9043209,5384,"reading"
"14815",38,1,179,94,9044700,9047493,2793,"reading"
"14929",38,1,160,95,9048925,9053759,4834,"reading"
"15131",38,1,169,96,9059389,9062426,3037,"reading"
"15229",38,1,152,97,9064378,9069326,4948,"reading"
"15429",38,1,154,98,9074383,9077927,3544,"reading"
"15626",38,1,161,99,9082035,9085477,3442,"reading"
"15821",38,1,175,100,9090345,9092344,1999,"reading"
"15929",38,1,159,101,9093684,9098344,4660,"reading"
"16133",38,1,164,102,9103139,9106428,3289,"reading"
"16230",38,1,165,103,9108333,9114045,5712,"reading"
"16324",38,1,162,104,9115885,9119712,3827,"reading"
"16525",38,1,173,105,9124219,9126879,2660,"reading"
"16626",38,1,171,106,9128573,9131712,3139,"reading"
"16728",38,1,172,107,9133015,9136146,3131,"reading"
"16826",38,1,178,108,9138027,9144446,6419,"reading"
"16926",38,1,153,109,9145852,9150079,4227,"reading"
"17132",38,1,174,110,9154016,9157313,3297,"reading"
"17228",38,1,156,111,9158883,9163196,4313,"reading"
"17427",38,1,158,112,9171029,9176047,5018,"reading"
"17626",38,1,157,113,9186843,9195764,8921,"reading"
"17823",38,1,177,114,9201415,9206815,5400,"reading"
"17928",38,1,170,115,9208460,9213415,4955,"reading"
"18028",38,1,155,116,9214971,9223265,8294,"reading"
"18231",38,1,151,117,9228436,9232932,4496,"reading"
"18425",38,1,166,118,9238261,9249766,11505,"reading"
"18526",38,1,168,119,9251578,9255399,3821,"reading"
"18624",38,1,167,120,9257119,9260183,3064,"reading"
"18732",38,2,91,121,9263994,9268667,4673,"reading"
"18932",38,2,92,122,9273424,9276117,2693,"reading"
"19132",38,2,93,123,9281416,9286484,5068,"reading"
"19330",38,2,97,124,9290846,9293250,2404,"reading"
"19529",38,3,126,125,9296763,9300668,3905,"reading"
"19728",38,3,132,126,9305891,9309134,3243,"reading"
"19925",38,2,113,127,9314071,9316485,2414,"reading"
"20030",38,2,117,128,9318679,9321768,3089,"reading"
"20132",38,2,116,129,9323327,9327018,3691,"reading"
"20226",38,2,101,130,9328632,9332385,3753,"reading"
"20429",38,3,121,131,9337654,9341536,3882,"reading"
"20629",38,2,108,132,9364773,9367720,2947,"reading"
"20730",38,2,107,133,9369071,9371937,2866,"reading"
"20827",38,2,114,134,9373351,9379037,5686,"reading"
"20929",38,3,123,135,9380795,9383404,2609,"reading"
"21133",38,2,104,136,9388872,9392087,3215,"reading"
"21226",38,3,143,137,9394545,9397821,3276,"reading"
"21326",38,2,96,138,9400388,9402905,2517,"reading"
"21527",38,2,115,139,9407302,9409471,2169,"reading"
"21624",38,3,150,140,9411197,9414388,3191,"reading"
"21729",38,2,98,141,9416194,9421705,5511,"reading"
"21927",38,3,130,142,9426064,9430723,4659,"reading"
"22136",38,2,109,143,9434594,9437323,2729,"reading"
"22229",38,3,138,144,9439189,9442723,3534,"reading"
"22329",38,3,141,145,9444202,9448789,4587,"reading"
"22429",38,3,136,146,9450563,9455973,5410,"reading"
"22525",38,3,124,147,9457143,9460840,3697,"reading"
"22726",38,2,103,148,9465993,9470440,4447,"reading"
"22829",38,3,133,149,9471876,9475457,3581,"reading"
"22927",38,3,131,150,9476970,9480057,3087,"reading"
"23135",38,2,110,151,9484750,9487191,2441,"reading"
"23224",38,3,137,152,9488587,9492008,3421,"reading"
"23332",38,3,139,153,9493360,9496891,3531,"reading"
"23429",38,2,95,154,9499434,9503725,4291,"reading"
"23627",38,3,128,155,9509444,9513541,4097,"reading"
"23830",38,2,102,156,9519228,9521709,2481,"reading"
"24027",38,3,134,157,9527538,9532142,4604,"reading"
"24130",38,3,122,158,9534124,9537392,3268,"reading"
"24329",38,3,125,159,9541863,9545009,3146,"reading"
"24530",38,2,119,160,9550360,9554643,4283,"reading"
"24627",38,3,149,161,9556087,9559460,3373,"reading"
"24724",38,3,146,162,9562313,9565543,3230,"reading"
"24827",38,2,118,163,9567231,9570377,3146,"reading"
"24926",38,3,147,164,9571864,9577611,5747,"reading"
"25026",38,2,94,165,9578945,9581478,2533,"reading"
"25226",38,2,106,166,9586334,9589877,3543,"reading"
"25327",38,3,129,167,9594450,9598161,3711,"reading"
"25527",38,2,111,168,9601972,9603962,1990,"reading"
"25627",38,3,144,169,9605401,9608612,3211,"reading"
"25730",38,3,140,170,9610036,9613545,3509,"reading"
"25827",38,3,145,171,9614930,9618295,3365,"reading"
"25924",38,2,100,172,9619768,9622695,2927,"reading"
"26129",38,2,120,173,9627714,9632979,5265,"reading"
"26228",38,3,142,174,9635061,9640146,5085,"reading"
"26328",38,3,127,175,9642038,9644646,2608,"reading"
"26525",38,2,99,176,9650830,9653780,2950,"reading"
"26724",38,2,105,177,9657946,9660797,2851,"reading"
"26831",38,2,112,178,9662298,9666247,3949,"reading"
"26922",38,3,148,179,9667655,9670981,3326,"reading"
"27032",38,3,135,180,9672533,9676114,3581,"reading"
"10140",39,2,61,1,10008045,10012098,4053,"reading"
"12133",39,2,62,2,10020612,10025132,4520,"reading"
"1438",39,2,63,3,10033190,10037599,4409,"reading"
"16109",39,3,20,4,10043280,10047099,3819,"reading"
"17133",39,2,85,5,10050289,10054500,4211,"reading"
"18106",39,2,83,6,10064476,10067984,3508,"reading"
"19133",39,2,69,7,10070380,10074484,4104,"reading"
"21134",39,3,9,8,10080455,10084168,3713,"reading"
"23136",39,3,27,9,10089332,10094651,5319,"reading"
"24107",39,2,65,10,10098567,10104501,5934,"reading"
"26109",39,3,7,11,10109828,10115252,5424,"reading"
"2821",39,3,13,12,10123861,10128786,4925,"reading"
"2931",39,3,26,13,10132070,10137136,5066,"reading"
"3028",39,3,14,14,10139677,10144903,5226,"reading"
"3128",39,2,82,15,10148346,10152953,4607,"reading"
"3231",39,2,90,16,10155005,10158437,3432,"reading"
"3328",39,3,19,17,10160865,10165537,4672,"reading"
"3424",39,3,24,18,10167699,10171954,4255,"reading"
"3531",39,2,66,19,10174190,10178154,3964,"reading"
"3732",39,3,10,20,10184222,10188255,4033,"reading"
"3928",39,3,12,21,10193036,10198755,5719,"reading"
"4130",39,2,79,22,10204105,10208338,4233,"reading"
"4225",39,3,22,23,10212088,10217622,5534,"reading"
"4331",39,2,68,24,10219736,10224272,4536,"reading"
"4530",39,2,73,25,10229529,10233222,3693,"reading"
"4624",39,2,87,26,10235313,10239239,3926,"reading"
"4729",39,3,2,27,10241295,10247123,5828,"reading"
"4930",39,3,15,28,10252974,10258057,5083,"reading"
"5025",39,2,72,29,10260932,10265307,4375,"reading"
"5231",39,3,28,30,10272235,10276057,3822,"reading"
"5318",39,2,84,31,10277819,10281791,3972,"reading"
"5428",39,2,64,32,10284401,10287957,3556,"reading"
"5629",39,2,88,33,10297115,10301591,4476,"reading"
"5717",39,3,4,34,10303915,10309058,5143,"reading"
"5927",39,2,75,35,10316616,10322159,5543,"reading"
"6030",39,3,21,36,10323865,10328259,4394,"reading"
"6128",39,2,67,37,10330055,10333242,3187,"reading"
"6329",39,3,16,38,10339989,10344193,4204,"reading"
"6428",39,3,6,39,10349028,10353443,4415,"reading"
"6627",39,2,76,40,10359384,10363010,3626,"reading"
"6727",39,2,81,41,10365957,10371661,5704,"reading"
"6829",39,3,18,42,10467994,10471914,3920,"reading"
"6930",39,3,5,43,10473899,10478381,4482,"reading"
"7130",39,2,80,44,10483822,10488148,4326,"reading"
"7226",39,3,30,45,10489729,10493615,3886,"reading"
"7330",39,2,71,46,10495532,10500765,5233,"reading"
"7530",39,2,77,47,10508914,10512732,3818,"reading"
"7628",39,3,25,48,10515276,10519932,4656,"reading"
"7727",39,3,3,49,10522535,10527466,4931,"reading"
"7931",39,3,29,50,10533356,10537750,4394,"reading"
"8027",39,3,11,51,10539517,10544666,5149,"reading"
"8226",39,2,74,52,10549628,10553917,4289,"reading"
"8330",39,3,1,53,10555869,10560917,5048,"reading"
"8526",39,2,78,54,10566424,10570601,4177,"reading"
"8624",39,3,17,55,10573603,10579801,6198,"reading"
"8727",39,3,23,56,10581650,10585668,4018,"reading"
"8827",39,2,70,57,10590330,10595068,4738,"reading"
"9031",39,2,86,58,10600146,10606085,5939,"reading"
"9131",39,2,89,59,10609057,10613835,4778,"reading"
"9224",39,3,8,60,10617333,10622086,4753,"reading"
"9431",39,1,35,61,10629213,10632969,3756,"reading"
"9628",39,1,51,62,10638699,10643253,4554,"reading"
"9725",39,1,55,63,10644996,10648087,3091,"reading"
"9828",39,1,59,64,10651313,10654003,2690,"reading"
"9927",39,1,41,65,10661360,10663820,2460,"reading"
"10141",39,1,47,66,10670358,10675370,5012,"reading"
"10233",39,1,43,67,10677594,10680154,2560,"reading"
"10327",39,1,40,68,10683350,10686171,2821,"reading"
"10529",39,1,45,69,10691434,10695621,4187,"reading"
"10629",39,1,53,70,10698151,10702022,3871,"reading"
"10727",39,1,36,71,10704701,10707655,2954,"reading"
"10926",39,1,54,72,10712006,10715689,3683,"reading"
"11026",39,1,31,73,10717533,10720689,3156,"reading"
"11222",39,1,50,74,10726353,10729989,3636,"reading"
"11329",39,1,44,75,10732407,10735423,3016,"reading"
"11426",39,1,39,76,10738875,10743356,4481,"reading"
"11629",39,1,38,77,10748027,10752007,3980,"reading"
"11824",39,1,33,78,10758646,10762107,3461,"reading"
"12033",39,1,58,79,10767749,10771275,3526,"reading"
"12134",39,1,56,80,10773342,10776658,3316,"reading"
"12226",39,1,60,81,10778616,10781575,2959,"reading"
"12327",39,1,34,82,10783737,10787008,3271,"reading"
"12526",39,1,32,83,10795191,10798858,3667,"reading"
"12729",39,1,42,84,10808914,10812076,3162,"reading"
"12921",39,1,49,85,10819036,10821793,2757,"reading"
"13031",39,1,46,86,10823668,10827476,3808,"reading"
"13122",39,1,48,87,10829837,10833327,3490,"reading"
"13231",39,1,52,88,10835462,10839493,4031,"reading"
"13332",39,1,37,89,10842125,10845060,2935,"reading"
"13527",39,1,57,90,10850416,10854444,4028,"reading"
"14531",39,2,151,91,11033503,11039050,5547,"zString"
"14730",39,2,152,92,11043459,11049917,6458,"zString"
"14930",39,2,153,93,11055181,11060667,5486,"zString"
"15132",39,3,113,94,11064861,11070685,5824,"zString"
"15230",39,2,179,95,11072407,11079101,6694,"zString"
"15323",39,2,158,96,11082163,11089301,7138,"zString"
"15529",39,2,177,97,11093074,11098535,5461,"zString"
"15627",39,2,160,98,11102392,11109135,6743,"zString"
"15822",39,2,172,99,11113140,11120619,7479,"zString"
"15930",39,2,159,100,11122653,11129153,6500,"zString"
"16134",39,2,174,101,11134203,11141703,7500,"zString"
"16231",39,2,154,102,11144062,11150554,6492,"zString"
"16431",39,3,103,103,11155069,11161537,6468,"zString"
"16526",39,2,167,104,11163395,11170354,6959,"zString"
"16627",39,3,91,105,11180178,11187024,6846,"zString"
"16827",39,2,180,106,11190648,11197872,7224,"zString"
"16927",39,2,166,107,11204021,11209722,5701,"zString"
"17025",39,2,171,108,11214575,11219840,5265,"zString"
"17134",39,3,102,109,11225243,11230373,5130,"zString"
"17326",39,2,168,110,11235927,11243007,7080,"zString"
"17428",39,3,92,111,11244782,11251990,7208,"zString"
"17627",39,3,105,112,11256346,11261141,4795,"zString"
"17728",39,3,104,113,11266926,11273358,6432,"zString"
"17824",39,3,120,114,11276567,11283659,7092,"zString"
"17929",39,2,163,115,11287636,11293276,5640,"zString"
"18029",39,3,96,116,11294820,11301025,6205,"zString"
"18232",39,3,119,117,11305942,11313526,7584,"zString"
"18323",39,3,116,118,11315510,11323560,8050,"zString"
"18426",39,2,165,119,11326067,11334811,8744,"zString"
"18527",39,3,95,120,11338307,11344411,6104,"zString"
"18733",39,3,99,121,11350944,11357527,6583,"zString"
"18933",39,2,175,122,11362233,11368912,6679,"zString"
"19019",39,3,110,123,11372106,11379045,6939,"zString"
"19134",39,3,112,124,11381267,11387812,6545,"zString"
"19222",39,2,170,125,11390226,11396412,6186,"zString"
"19331",39,2,162,126,11398412,11403846,5434,"zString"
"19530",39,3,93,127,11408507,11414731,6224,"zString"
"19729",39,2,169,128,11420273,11425213,4940,"zString"
"19826",39,3,114,129,11427922,11433897,5975,"zString"
"19926",39,3,109,130,11437525,11442530,5005,"zString"
"20031",39,2,178,131,11445160,11452664,7504,"zString"
"20133",39,3,111,132,11607974,11613269,5295,"zString"
"20227",39,3,117,133,11615182,11620053,4871,"zString"
"20322",39,3,115,134,11622264,11626936,4672,"zString"
"20430",39,3,108,135,11628903,11634620,5717,"zString"
"20525",39,2,155,136,11636668,11642537,5869,"zString"
"20731",39,3,94,137,11647209,11654838,7629,"zString"
"20930",39,2,161,138,11659574,11665171,5597,"zString"
"21135",39,2,157,139,11671207,11676788,5581,"zString"
"21327",39,2,156,140,11681160,11687822,6662,"zString"
"21528",39,3,118,141,11692985,11698389,5404,"zString"
"21625",39,2,164,142,11700347,11705822,5475,"zString"
"21730",39,3,97,143,11707715,11712756,5041,"zString"
"21928",39,3,100,144,11719541,11726856,7315,"zString"
"22137",39,3,106,145,11731493,11738457,6964,"zString"
"22230",39,3,107,146,11742247,11747707,5460,"zString"
"22330",39,2,176,147,11752450,11757425,4975,"zString"
"22430",39,3,101,148,11759168,11763708,4540,"zString"
"22623",39,3,98,149,11768451,11774375,5924,"zString"
"22830",39,2,173,150,11778892,11784242,5350,"zString"
"22928",39,1,126,151,11786618,11792298,5680,"zString"
"23137",39,1,134,152,11796435,11800893,4458,"zString"
"23225",39,1,124,153,11803730,11808360,4630,"zString"
"23430",39,1,128,154,11813800,11818527,4727,"zString"
"23628",39,1,138,155,11822854,11826244,3390,"zString"
"23724",39,1,121,156,11828612,11833327,4715,"zString"
"23923",39,1,132,157,11838382,11843995,5613,"zString"
"24131",39,1,136,158,11849754,11855044,5290,"zString"
"24226",39,1,149,159,11856899,11861878,4979,"zString"
"24330",39,1,148,160,11864638,11869962,5324,"zString"
"24428",39,1,139,161,11872314,11877679,5365,"zString"
"24531",39,1,150,162,11880172,11884979,4807,"zString"
"24628",39,1,143,163,11890491,11896429,5938,"zString"
"24725",39,1,123,164,11898693,11906346,7653,"zString"
"24927",39,1,129,165,11912218,11918130,5912,"zString"
"25131",39,1,135,166,11924606,11932497,7891,"zString"
"25227",39,1,144,167,11935357,11943065,7708,"zString"
"25328",39,1,145,168,11946125,11953747,7622,"zString"
"25425",39,1,127,169,11960848,11969415,8567,"zString"
"25628",39,1,147,170,11974281,11980848,6567,"zString"
"25731",39,1,141,171,11986077,11992015,5938,"zString"
"25828",39,1,133,172,11994748,12002233,7485,"zString"
"25925",39,1,140,173,12006902,12013633,6731,"zString"
"26031",39,1,122,174,12016693,12022750,6057,"zString"
"26229",39,1,130,175,12028684,12034051,5367,"zString"
"26425",39,1,125,176,12040790,12046668,5878,"zString"
"26627",39,1,142,177,12051046,12056502,5456,"zString"
"26725",39,1,146,178,12059725,12066985,7260,"zString"
"26832",39,1,131,179,12069139,12076369,7230,"zString"
"27033",39,1,137,180,12080931,12086302,5371,"zString"
"10142",40,2,31,1,12935426,12944181,8755,"zString"
"12135",40,2,32,2,12948048,12960882,12834,"zString"
"1439",40,2,33,3,12965214,12971566,6352,"zString"
"16135",40,3,67,4,12975355,12981183,5828,"zString"
"18107",40,3,65,5,12984902,12990166,5264,"zString"
"20106",40,3,64,6,12996465,13001667,5202,"zString"
"22138",40,3,85,7,13006853,13012667,5814,"zString"
"23138",40,2,42,8,13014510,13020734,6224,"zString"
"25132",40,3,82,9,13024927,13032635,7708,"zString"
"26130",40,2,36,10,13034443,13042935,8492,"zString"
"2822",40,2,51,11,13046896,13052985,6089,"zString"
"2932",40,2,49,12,13054520,13060885,6365,"zString"
"3029",40,2,47,13,13063476,13070719,7243,"zString"
"3129",40,3,79,14,13073562,13077186,3624,"zString"
"3232",40,2,46,15,13081122,13086003,4881,"zString"
"3329",40,2,59,16,13088405,13096937,8532,"zString"
"3425",40,2,34,17,13099248,13104421,5173,"zString"
"3624",40,2,57,18,13109996,13117654,7658,"zString"
"3733",40,3,66,19,13119178,13122854,3676,"zString"
"3929",40,2,52,20,13126905,13132254,5349,"zString"
"4027",40,3,88,21,13135161,13139722,4561,"zString"
"4131",40,3,89,22,13141986,13146739,4753,"zString"
"4226",40,2,48,23,13150694,13155189,4495,"zString"
"4332",40,3,71,24,13157405,13163406,6001,"zString"
"4531",40,3,74,25,13168092,13173339,5247,"zString"
"4625",40,3,83,26,13176232,13180806,4574,"zString"
"4730",40,2,37,27,13183204,13189540,6336,"zString"
"4931",40,3,86,28,13194076,13197990,3914,"zString"
"5026",40,3,68,29,13200341,13205523,5182,"zString"
"5232",40,2,53,30,13210936,13217157,6221,"zString"
"5319",40,3,77,31,13218727,13225108,6381,"zString"
"5429",40,2,44,32,13227611,13232941,5330,"zString"
"5515",40,2,38,33,13234290,13238592,4302,"zString"
"5718",40,3,80,34,13245251,13250292,5041,"zString"
"5828",40,3,84,35,13252478,13256892,4414,"zString"
"5928",40,2,58,36,13259289,13264759,5470,"zString"
"6031",40,3,76,37,13266639,13270776,4137,"zString"
"6129",40,3,70,38,13272581,13278993,6412,"zString"
"6330",40,2,39,39,13284562,13290377,5815,"zString"
"6527",40,2,43,40,13294364,13298610,4246,"zString"
"6628",40,2,45,41,13300879,13310311,9432,"zString"
"6728",40,2,50,42,13370187,13374029,3842,"zString"
"6830",40,2,55,43,13376474,13380313,3839,"zString"
"6931",40,3,75,44,13382184,13385680,3496,"zString"
"7029",40,2,35,45,13391502,13394614,3112,"zString"
"7227",40,3,61,46,13398883,13402430,3547,"zString"
"7429",40,2,54,47,13406879,13411931,5052,"zString"
"7531",40,3,78,48,13414147,13419565,5418,"zString"
"7629",40,3,62,49,13422100,13426048,3948,"zString"
"7825",40,3,90,50,13430070,13433132,3062,"zString"
"7932",40,2,41,51,13434493,13439349,4856,"zString"
"8127",40,2,60,52,13443836,13446998,3162,"zString"
"8227",40,2,40,53,13451064,13455199,4135,"zString"
"8429",40,2,56,54,13459828,13463583,3755,"zString"
"8527",40,3,63,55,13468781,13473166,4385,"zString"
"8728",40,3,87,56,13478423,13482967,4544,"zString"
"8828",40,3,73,57,13484971,13489433,4462,"zString"
"8930",40,3,72,58,13491425,13495184,3759,"zString"
"9132",40,3,69,59,13499741,13504567,4826,"zString"
"9328",40,3,81,60,13509478,13514184,4706,"zString"
"9432",40,1,27,61,13516983,13520585,3602,"zString"
"9532",40,1,29,62,13523305,13530118,6813,"zString"
"9629",40,1,10,63,13534525,13538518,3993,"zString"
"9829",40,1,14,64,13543312,13547619,4307,"zString"
"9928",40,1,13,65,13550190,13555502,5312,"zString"
"10027",40,1,1,66,13557330,13563236,5906,"zString"
"10234",40,1,5,67,13567675,13571403,3728,"zString"
"10427",40,1,2,68,13575731,13581220,5489,"zString"
"10630",40,1,9,69,13584917,13590353,5436,"zString"
"10829",40,1,17,70,13594016,13600637,6621,"zString"
"10927",40,1,12,71,13607523,13611471,3948,"zString"
"11130",40,1,18,72,13615763,13619138,3375,"zString"
"11223",40,1,4,73,13622119,13625805,3686,"zString"
"11427",40,1,8,74,13630776,13634505,3729,"zString"
"11630",40,1,11,75,13638647,13645772,7125,"zString"
"11825",40,1,6,76,13651001,13654656,3655,"zString"
"12034",40,1,22,77,13658406,13662306,3900,"zString"
"12136",40,1,7,78,13664173,13667506,3333,"zString"
"12328",40,1,16,79,13672645,13676907,4262,"zString"
"12426",40,1,20,80,13680152,13683390,3238,"zString"
"12527",40,1,24,81,13686276,13690007,3731,"zString"
"12629",40,1,30,82,13693273,13699224,5951,"zString"
"12730",40,1,23,83,13701268,13703658,2390,"zString"
"12829",40,1,19,84,13706690,13711474,4784,"zString"
"12922",40,1,25,85,13714396,13717791,3395,"zString"
"13032",40,1,28,86,13721681,13725974,4293,"zString"
"13123",40,1,26,87,13727587,13733725,6138,"zString"
"13232",40,1,21,88,13735877,13740292,4415,"zString"
"13333",40,1,15,89,13742750,13747109,4359,"zString"
"13425",40,1,3,90,13749376,13752509,3133,"zString"
"14532",40,2,121,91,13920245,13925699,5454,"reading"
"14731",40,2,122,92,13931027,13937215,6188,"reading"
"14931",40,2,123,93,13942170,13947316,5146,"reading"
"15133",40,2,124,94,13953381,13958850,5469,"reading"
"15324",40,2,144,95,13963696,13971016,7320,"reading"
"15430",40,3,179,96,13974184,13978717,4533,"reading"
"15530",40,2,143,97,13980649,13985483,4834,"reading"
"15628",40,3,163,98,13987607,13993017,5410,"reading"
"15730",40,3,160,99,13996878,14002501,5623,"reading"
"15931",40,3,164,100,14011891,14019268,7377,"reading"
"16025",40,3,168,101,14022449,14028352,5903,"reading"
"16136",40,2,145,102,14031209,14036519,5310,"reading"
"16232",40,3,171,103,14038712,14045586,6874,"reading"
"16325",40,3,152,104,14048281,14054902,6621,"reading"
"16527",40,3,156,105,14060889,14066054,5165,"reading"
"16729",40,3,155,106,14072006,14085387,13381,"reading"
"16928",40,3,167,107,14093051,14099971,6920,"reading"
"17026",40,3,177,108,14101706,14107438,5732,"reading"
"17135",40,2,141,109,14109207,14115505,6298,"reading"
"17229",40,2,149,110,14117570,14122722,5152,"reading"
"17327",40,2,131,111,14125020,14128155,3135,"reading"
"17527",40,3,158,112,14133721,14140172,6451,"reading"
"17729",40,2,137,113,14146783,14153356,6573,"reading"
"17825",40,3,176,114,14158641,14164223,5582,"reading"
"17930",40,3,173,115,14166690,14173640,6950,"reading"
"18030",40,2,130,116,14178491,14185257,6766,"reading"
"18233",40,2,132,117,14190901,14199191,8290,"reading"
"18427",40,2,128,118,14204966,14209958,4992,"reading"
"18625",40,2,146,119,14215203,14222542,7339,"reading"
"18734",40,2,148,120,14224986,14231309,6323,"reading"
"18812",40,3,180,121,14233461,14237309,3848,"reading"
"18934",40,2,150,122,14239166,14244976,5810,"reading"
"19020",40,2,136,123,14247961,14253310,5349,"reading"
"19135",40,3,162,124,14255884,14261443,5559,"reading"
"19332",40,3,175,125,14270473,14275294,4821,"reading"
"19425",40,2,129,126,14277507,14285511,8004,"reading"
"19627",40,3,172,127,14290950,14297161,6211,"reading"
"19730",40,2,135,128,14299411,14306395,6984,"reading"
"19827",40,2,126,129,14309157,14313161,4004,"reading"
"20032",40,2,127,130,14318447,14325512,7065,"reading"
"20228",40,2,142,131,14331736,14339029,7293,"reading"
"20323",40,3,153,132,14458436,14463500,5064,"reading"
"20526",40,3,165,133,14468532,14476384,7852,"reading"
"20630",40,2,139,134,14478525,14482467,3942,"reading"
"20732",40,3,157,135,14484959,14491084,6125,"reading"
"20931",40,3,169,136,14495980,14501268,5288,"reading"
"21029",40,2,133,137,14503618,14510202,6584,"reading"
"21136",40,3,178,138,14514018,14523918,9900,"reading"
"21227",40,3,159,139,14527266,14533269,6003,"reading"
"21426",40,3,161,140,14539777,14547203,7426,"reading"
"21626",40,2,134,141,14555639,14560904,5265,"reading"
"21731",40,2,125,142,14563262,14571821,8559,"reading"
"21929",40,3,170,143,14579443,14584854,5411,"reading"
"22027",40,3,174,144,14587156,14596588,9432,"reading"
"22139",40,3,166,145,14601271,14609005,7734,"reading"
"22231",40,2,140,146,14610905,14615555,4650,"reading"
"22331",40,3,154,147,14618450,14625822,7372,"reading"
"22526",40,2,147,148,14630244,14637206,6962,"reading"
"22624",40,2,138,149,14638959,14644440,5481,"reading"
"22727",40,3,151,150,14646200,14654257,8057,"reading"
"22929",40,1,112,151,14660491,14665557,5066,"reading"
"23026",40,1,118,152,14668378,14675724,7346,"reading"
"23139",40,1,111,153,14678454,14683458,5004,"reading"
"23226",40,1,117,154,14685372,14689258,3886,"reading"
"23333",40,1,107,155,14691275,14694291,3016,"reading"
"23431",40,1,108,156,14695829,14700175,4346,"reading"
"23526",40,1,119,157,14701994,14708325,6331,"reading"
"23629",40,1,113,158,14710066,14713959,3893,"reading"
"23725",40,1,101,159,14715534,14721342,5808,"reading"
"23924",40,1,109,160,14727045,14730726,3681,"reading"
"24028",40,1,120,161,14732664,14740393,7729,"reading"
"24132",40,1,96,162,14742736,14747826,5090,"reading"
"24331",40,1,115,163,14755476,14762477,7001,"reading"
"24429",40,1,100,164,14764594,14774294,9700,"reading"
"24629",40,1,110,165,14778323,14782211,3888,"reading"
"24726",40,1,97,166,14784602,14787411,2809,"reading"
"24928",40,1,116,167,14792203,14797878,5675,"reading"
"25027",40,1,95,168,14799987,14805762,5775,"reading"
"25228",40,1,106,169,14811418,14817928,6510,"reading"
"25329",40,1,93,170,14820121,14824698,4577,"reading"
"25528",40,1,99,171,14829754,14835213,5459,"reading"
"25732",40,1,103,172,14840434,14846930,6496,"reading"
"25829",40,1,92,173,14849001,14851913,2912,"reading"
"26032",40,1,114,174,14858633,14867030,8397,"reading"
"26131",40,1,104,175,14869257,14873797,4540,"reading"
"26230",40,1,105,176,14875768,14880797,5029,"reading"
"26329",40,1,91,177,14883048,14888481,5433,"reading"
"26526",40,1,94,178,14894567,14898698,4131,"reading"
"26726",40,1,102,179,14903252,14907882,4630,"reading"
"26923",40,1,98,180,14916420,14920782,4362,"reading"
"10143",41,1,71,1,1062346,1065650,3304,"reading"
"12137",41,1,73,2,1071823,1075835,4012,"reading"
"1370",41,1,88,3,1077748,1083218,5470,"reading"
"1440",41,1,61,4,1085416,1091769,6353,"reading"
"16137",41,1,62,5,1097768,1101619,3851,"reading"
"18108",41,1,80,6,1106277,1112919,6642,"reading"
"19136",41,1,81,7,1114901,1119220,4319,"reading"
"20107",41,1,65,8,1121117,1125970,4853,"reading"
"22140",41,1,89,9,1131800,1135053,3253,"reading"
"23140",41,1,83,10,1137014,1140870,3856,"reading"
"24108",41,1,75,11,1142836,1148121,5285,"reading"
"25133",41,1,78,12,1150926,1153721,2795,"reading"
"26132",41,1,77,13,1155300,1158437,3137,"reading"
"2745",41,1,69,14,1160260,1163704,3444,"reading"
"2933",41,1,76,15,1169759,1171905,2146,"reading"
"3030",41,1,90,16,1174712,1177921,3209,"reading"
"3130",41,1,68,17,1179988,1185038,5050,"reading"
"3330",41,1,84,18,1191182,1194522,3340,"reading"
"3426",41,1,85,19,1196583,1201539,4956,"reading"
"3532",41,1,82,20,1203759,1210972,7213,"reading"
"3625",41,1,74,21,1212768,1218906,6138,"reading"
"3734",41,1,66,22,1220512,1223906,3394,"reading"
"3930",41,1,86,23,1230520,1235157,4637,"reading"
"4028",41,1,63,24,1236850,1239740,2890,"reading"
"4227",41,1,70,25,1246790,1252741,5951,"reading"
"4429",41,1,64,26,1257121,1263308,6187,"reading"
"4626",41,1,72,27,1272520,1276825,4305,"reading"
"4823",41,1,87,28,1281855,1285508,3653,"reading"
"4932",41,1,79,29,1287293,1290709,3416,"reading"
"5027",41,1,67,30,1293717,1298392,4675,"reading"
"5233",41,2,1,31,1304582,1309059,4477,"reading"
"5430",41,2,2,32,1312909,1319909,7000,"reading"
"5630",41,2,3,33,1324594,1326710,2116,"reading"
"5829",41,2,21,34,1333129,1338527,5398,"reading"
"5929",41,3,44,35,1340767,1343060,2293,"reading"
"6032",41,3,43,36,1346353,1349960,3607,"reading"
"6130",41,2,4,37,1353893,1357511,3618,"reading"
"6331",41,3,52,38,1365016,1369045,4029,"reading"
"6429",41,2,15,39,1371576,1375045,3469,"reading"
"6528",41,2,18,40,1379039,1383861,4822,"reading"
"6629",41,3,50,41,1386948,1392162,5214,"reading"
"6729",41,3,42,42,1445170,1448532,3362,"reading"
"6932",41,3,34,43,1453540,1457516,3976,"reading"
"7131",41,2,29,44,1461794,1466266,4472,"reading"
"7228",41,2,9,45,1468432,1471450,3018,"reading"
"7430",41,3,33,46,1477905,1482117,4212,"reading"
"7630",41,3,36,47,1487882,1490750,2868,"reading"
"7826",41,3,46,48,1495383,1499084,3701,"reading"
"7933",41,3,59,49,1501343,1503701,2358,"reading"
"8028",41,3,40,50,1505671,1508101,2430,"reading"
"8228",41,2,24,51,1513372,1517002,3630,"reading"
"8331",41,2,12,52,1519027,1522618,3591,"reading"
"8528",41,2,22,53,1528121,1531068,2947,"reading"
"8625",41,2,27,54,1533105,1536836,3731,"reading"
"8729",41,2,17,55,1538701,1543786,5085,"reading"
"8829",41,2,23,56,1545720,1549769,4049,"reading"
"8931",41,3,53,57,1551471,1554653,3182,"reading"
"9032",41,2,19,58,1556613,1560086,3473,"reading"
"9133",41,3,47,59,1561893,1565903,4010,"reading"
"9225",41,3,58,60,1568399,1571770,3371,"reading"
"9329",41,2,13,61,1573970,1578087,4117,"reading"
"9433",41,3,57,62,1579878,1583203,3325,"reading"
"9533",41,3,41,63,1585661,1588054,2393,"reading"
"9726",41,2,28,64,1593229,1596737,3508,"reading"
"9830",41,2,26,65,1598285,1602238,3953,"reading"
"9929",41,2,14,66,1604494,1608238,3744,"reading"
"10028",41,3,45,67,1610280,1614488,4208,"reading"
"10144",41,2,30,68,1616393,1623205,6812,"reading"
"10235",41,2,6,69,1624902,1628938,4036,"reading"
"10428",41,3,55,70,1634740,1640939,6199,"reading"
"10530",41,2,16,71,1642495,1646073,3578,"reading"
"10631",41,3,54,72,1648340,1651206,2866,"reading"
"10728",41,3,49,73,1653208,1657656,4448,"reading"
"10830",41,3,35,74,1659812,1662356,2544,"reading"
"11027",41,2,20,75,1667109,1670140,3031,"reading"
"11131",41,3,60,76,1671683,1673990,2307,"reading"
"11224",41,3,38,77,1675647,1678757,3110,"reading"
"11428",41,3,48,78,1684056,1690541,6485,"reading"
"11521",41,2,8,79,1694272,1698708,4436,"reading"
"11727",41,3,56,80,1704823,1708292,3469,"reading"
"11826",41,3,32,81,1710977,1713841,2864,"reading"
"12035",41,2,5,82,1718774,1721825,3051,"reading"
"12227",41,3,39,83,1726242,1730459,4217,"reading"
"12427",41,3,51,84,1736612,1741609,4997,"reading"
"12528",41,2,7,85,1743793,1749126,5333,"reading"
"12731",41,2,25,86,1754524,1757643,3119,"reading"
"12830",41,3,31,87,1761889,1766343,4454,"reading"
"13033",41,3,37,88,1770994,1776494,5500,"reading"
"13233",41,2,11,89,1781497,1784610,3113,"reading"
"13426",41,2,10,90,1789270,1792344,3074,"reading"
"14533",41,1,162,91,1895873,1899148,3275,"zString"
"14732",41,1,172,92,1903450,1909048,5598,"zString"
"14816",41,1,179,93,1910806,1914115,3309,"zString"
"14932",41,1,159,94,1917793,1922982,5189,"zString"
"15134",41,1,174,95,1927996,1932265,4269,"zString"
"15231",41,1,160,96,1934504,1939366,4862,"zString"
"15431",41,1,151,97,1945335,1949666,4331,"zString"
"15629",41,1,154,98,1953609,1957583,3974,"zString"
"15823",41,1,167,99,1962048,1965917,3869,"zString"
"15932",41,1,152,100,1968940,1974300,5360,"zString"
"16138",41,1,170,101,1978669,1983101,4432,"zString"
"16233",41,1,163,102,1987140,1990317,3177,"zString"
"16326",41,1,177,103,1993572,1996534,2962,"zString"
"16432",41,1,168,104,1999352,2003284,3932,"zString"
"16528",41,1,166,105,2006036,2009268,3232,"zString"
"16628",41,1,164,106,2012430,2016818,4388,"zString"
"16730",41,1,173,107,2019575,2022535,2960,"zString"
"16828",41,1,161,108,2025291,2028802,3511,"zString"
"17027",41,1,180,109,2034889,2039653,4764,"zString"
"17136",41,1,178,110,2045002,2048686,3684,"zString"
"17230",41,1,175,111,2050153,2053220,3067,"zString"
"17328",41,1,169,112,2056686,2060103,3417,"zString"
"17429",41,1,158,113,2062820,2066353,3533,"zString"
"17628",41,1,155,114,2070351,2074754,4403,"zString"
"17826",41,1,171,115,2078685,2083437,4752,"zString"
"17931",41,1,156,116,2087526,2092021,4495,"zString"
"18129",41,1,157,117,2095819,2100971,5152,"zString"
"18324",41,1,176,118,2106439,2110638,4199,"zString"
"18428",41,1,165,119,2112608,2117789,5181,"zString"
"18528",41,1,153,120,2120578,2123906,3328,"zString"
"18735",41,2,91,121,2127769,2131722,3953,"zString"
"18935",41,2,92,122,2137001,2141756,4755,"zString"
"19137",41,2,93,123,2145960,2149023,3063,"zString"
"19333",41,2,103,124,2153092,2156789,3697,"zString"
"19426",41,2,111,125,2158871,2163257,4386,"zString"
"19531",41,2,95,126,2165698,2169824,4126,"zString"
"19731",41,3,146,127,2174793,2179107,4314,"zString"
"19828",41,3,124,128,2182465,2188324,5859,"zString"
"20033",41,2,101,129,2192694,2196458,3764,"zString"
"20229",41,3,123,130,2201553,2205075,3522,"zString"
"20431",41,3,141,131,2208729,2214975,6246,"zString"
"20527",41,2,119,132,2247840,2251343,3503,"zString"
"20631",41,3,127,133,2253092,2256943,3851,"zString"
"20828",41,2,107,134,2260919,2264227,3308,"zString"
"20932",41,2,99,135,2265763,2269244,3481,"zString"
"21137",41,2,94,136,2274865,2277594,2729,"zString"
"21328",41,3,147,137,2281023,2284527,3504,"zString"
"21427",41,2,118,138,2286928,2290161,3233,"zString"
"21529",41,3,140,139,2293211,2297161,3950,"zString"
"21627",41,2,102,140,2299532,2303078,3546,"zString"
"21828",41,2,115,141,2306846,2309995,3149,"zString"
"21930",41,2,100,142,2312051,2316795,4744,"zString"
"22141",41,2,98,143,2321458,2324629,3171,"zString"
"22332",41,3,132,144,2329571,2333445,3874,"zString"
"22527",41,2,120,145,2339964,2344446,4482,"zString"
"22625",41,3,138,146,2347889,2352130,4241,"zString"
"22728",41,2,104,147,2354248,2359213,4965,"zString"
"22831",41,2,106,148,2361166,2365396,4230,"zString"
"22930",41,3,137,149,2367311,2370447,3136,"zString"
"23027",41,2,108,150,2372286,2376080,3794,"zString"
"23141",41,3,150,151,2378673,2382397,3724,"zString"
"23227",41,2,113,152,2384578,2387747,3169,"zString"
"23334",41,2,109,153,2390061,2393014,2953,"zString"
"23432",41,3,149,154,2395875,2399014,3139,"zString"
"23527",41,3,122,155,2400563,2404248,3685,"zString"
"23726",41,2,96,156,2408522,2411782,3260,"zString"
"23925",41,3,135,157,2415586,2420465,4879,"zString"
"24029",41,3,143,158,2423604,2427965,4361,"zString"
"24133",41,2,114,159,2429894,2432716,2822,"zString"
"24227",41,3,126,160,2435707,2438866,3159,"zString"
"24430",41,3,139,161,2442950,2446249,3299,"zString"
"24532",41,2,97,162,2448847,2451483,2636,"zString"
"24727",41,2,116,163,2455025,2458417,3392,"zString"
"24828",41,2,117,164,2461061,2463750,2689,"zString"
"24929",41,3,148,165,2466181,2471600,5419,"zString"
"25028",41,3,131,166,2474177,2477684,3507,"zString"
"25229",41,3,144,167,2481686,2486484,4798,"zString"
"25330",41,3,129,168,2489254,2492534,3280,"zString"
"25529",41,3,133,169,2499530,2503735,4205,"zString"
"25629",41,3,130,170,2506301,2509952,3651,"zString"
"25830",41,3,142,171,2513984,2517552,3568,"zString"
"25926",41,3,128,172,2520031,2524736,4705,"zString"
"26133",41,3,134,173,2528279,2531302,3023,"zString"
"26231",41,3,145,174,2534825,2537602,2777,"zString"
"26330",41,3,121,175,2540232,2543186,2954,"zString"
"26527",41,3,136,176,2547579,2551586,4007,"zString"
"26628",41,2,110,177,2553312,2557737,4425,"zString"
"26727",41,2,112,178,2560448,2564904,4456,"zString"
"26833",41,3,125,179,2567663,2570837,3174,"zString"
"27034",41,2,105,180,2575510,2579321,3811,"zString"
"10145",42,1,46,1,4453250,4463491,10241,"zString"
"1180",42,1,45,2,4468666,4477258,8592,"zString"
"12138",42,1,36,3,4481992,4493358,11366,"zString"
"1441",42,1,50,4,4503236,4510159,6923,"zString"
"15102",42,1,37,5,4515628,4520892,5264,"zString"
"17137",42,1,40,6,4527844,4535327,7483,"zString"
"19138",42,1,55,7,4540541,4547127,6586,"zString"
"20108",42,1,44,8,4549659,4555661,6002,"zString"
"21138",42,1,58,9,4569420,4574445,5025,"zString"
"22142",42,1,47,10,4606340,4613229,6889,"zString"
"23142",42,1,48,11,4620529,4629613,9084,"zString"
"24109",42,1,53,12,4641476,4646263,4787,"zString"
"25134",42,1,34,13,4649304,4655063,5759,"zString"
"2746",42,1,57,14,4660125,4666731,6606,"zString"
"2823",42,1,49,15,4676172,4681498,5326,"zString"
"2934",42,1,56,16,4689593,4699199,9606,"zString"
"3031",42,1,43,17,4707721,4714266,6545,"zString"
"3131",42,1,60,18,4716605,4722016,5411,"zString"
"3233",42,1,38,19,4730773,4737600,6827,"zString"
"3427",42,1,51,20,4743671,4750600,6929,"zString"
"3533",42,1,39,21,4757178,4767651,10473,"zString"
"3735",42,1,31,22,4772153,4777968,5815,"zString"
"3931",42,1,59,23,4783813,4792002,8189,"zString"
"4029",42,1,42,24,4793783,4801419,7636,"zString"
"4228",42,1,52,25,4805918,4815552,9634,"zString"
"4333",42,1,35,26,4819601,4826887,7286,"zString"
"4532",42,1,33,27,4831796,4837754,5958,"zString"
"4731",42,1,54,28,4842817,4848754,5937,"zString"
"4824",42,1,41,29,4854548,4864505,9957,"zString"
"5028",42,1,32,30,4870120,4878738,8618,"zString"
"5234",42,2,61,31,4883111,4891722,8611,"zString"
"5431",42,2,62,32,4897138,4906639,9501,"zString"
"5631",42,2,63,33,4910565,4919339,8774,"zString"
"5830",42,3,24,34,4923629,4935107,11478,"zString"
"5930",42,2,88,35,4939268,4948240,8972,"zString"
"6033",42,3,11,36,4952579,4963858,11279,"zString"
"6223",42,2,75,37,4968795,4976325,7530,"zString"
"6332",42,2,86,38,4979113,4987442,8329,"zString"
"6430",42,3,23,39,4991676,4999109,7433,"zString"
"6529",42,2,79,40,5003437,5012109,8672,"zString"
"6630",42,3,16,41,5020272,5029126,8854,"zString"
"6730",42,3,29,42,5084154,5090431,6277,"zString"
"6831",42,2,72,43,5095727,5102298,6571,"zString"
"7030",42,2,76,44,5113015,5120765,7750,"zString"
"7132",42,2,67,45,5130082,5138866,8784,"zString"
"7331",42,3,12,46,5142972,5149599,6627,"zString"
"7532",42,2,82,47,5180988,5188254,7266,"zString"
"7631",42,3,25,48,5190730,5196634,5904,"zString"
"7728",42,3,13,49,5199309,5205168,5859,"zString"
"7827",42,2,87,50,5208429,5217835,9406,"zString"
"7934",42,2,66,51,5220362,5225502,5140,"zString"
"8128",42,3,3,52,5230237,5235885,5648,"zString"
"8332",42,2,69,53,5239843,5245969,6126,"zString"
"8529",42,2,85,54,5250734,5256569,5835,"zString"
"8626",42,3,28,55,5258497,5264936,6439,"zString"
"8730",42,3,1,56,5267022,5272153,5131,"zString"
"8932",42,2,68,57,5277296,5286587,9291,"zString"
"9134",42,3,21,58,5291108,5296171,5063,"zString"
"9226",42,2,64,59,5297871,5306638,8767,"zString"
"9434",42,2,89,60,5311104,5315938,4834,"zString"
"9534",42,3,15,61,5317723,5327155,9432,"zString"
"9630",42,3,20,62,5328788,5335789,7001,"zString"
"9727",42,2,90,63,5337513,5345022,7509,"zString"
"9831",42,3,2,64,5346499,5352739,6240,"zString"
"10029",42,3,19,65,5357369,5365157,7788,"zString"
"10146",42,2,73,66,5366735,5372307,5572,"zString"
"10236",42,2,84,67,5374104,5383807,9703,"zString"
"10328",42,3,22,68,5385792,5392174,6382,"zString"
"10429",42,2,65,69,5396912,5402975,6063,"zString"
"10632",42,2,70,70,5408302,5414258,5956,"zString"
"10831",42,3,6,71,5419645,5428626,8981,"zString"
"11028",42,3,18,72,5434135,5440892,6757,"zString"
"11132",42,3,9,73,5443434,5448726,5292,"zString"
"11330",42,3,7,74,5454061,5462493,8432,"zString"
"11522",42,2,71,75,5466984,5473893,6909,"zString"
"11728",42,3,5,76,5479384,5484827,5443,"zString"
"11926",42,3,30,77,5488941,5496144,7203,"zString"
"12036",42,2,81,78,5499838,5505611,5773,"zString"
"12139",42,3,14,79,5507806,5512811,5005,"zString"
"12228",42,3,10,80,5515256,5522795,7539,"zString"
"12428",42,2,83,81,5527168,5533846,6678,"zString"
"12529",42,3,17,82,5537017,5544962,7945,"zString"
"12630",42,2,77,83,5547209,5551480,4271,"zString"
"12732",42,3,8,84,5553856,5559796,5940,"zString"
"12923",42,3,26,85,5564352,5571130,6778,"zString"
"13034",42,2,74,86,5573216,5579347,6131,"zString"
"13124",42,3,27,87,5581498,5586914,5416,"zString"
"13234",42,3,4,88,5590812,5598181,7369,"zString"
"13427",42,2,78,89,5602430,5609665,7235,"zString"
"13528",42,2,80,90,5612135,5618948,6813,"zString"
"14534",42,1,124,91,5740585,5751589,11004,"reading"
"14733",42,1,133,92,5757441,5765123,7682,"reading"
"14817",42,1,150,93,5767269,5776090,8821,"reading"
"14933",42,1,123,94,5778411,5785707,7296,"reading"
"15135",42,1,131,95,5791388,5799391,8003,"reading"
"15325",42,1,145,96,5807123,5814241,7118,"reading"
"15432",42,1,126,97,5816481,5823992,7511,"reading"
"15630",42,1,136,98,5831199,5837992,6793,"reading"
"15731",42,1,144,99,5840176,5848842,8666,"reading"
"15824",42,1,122,100,5852090,5859076,6986,"reading"
"16026",42,1,139,101,5864412,5868476,4064,"reading"
"16139",42,1,125,102,5870517,5877894,7377,"reading"
"16327",42,1,146,103,5882916,5889677,6761,"reading"
"16433",42,1,148,104,5892111,5899244,7133,"reading"
"16529",42,1,135,105,5901183,5907061,5878,"reading"
"16629",42,1,130,106,5909127,5917828,8701,"reading"
"16829",42,1,138,107,5923685,5931212,7527,"reading"
"16929",42,1,137,108,5933108,5940679,7571,"reading"
"17028",42,1,127,109,5942671,5949213,6542,"reading"
"17231",42,1,140,110,5957012,5962596,5584,"reading"
"17329",42,1,132,111,5965569,5975764,10195,"reading"
"17528",42,1,147,112,5982625,5989164,6539,"reading"
"17629",42,1,141,113,5991687,5996981,5294,"reading"
"17730",42,1,121,114,5998950,6004881,5931,"reading"
"17932",42,1,149,115,6010548,6017898,7350,"reading"
"18031",42,1,129,116,6019911,6026015,6104,"reading"
"18234",42,1,128,117,6031385,6037515,6130,"reading"
"18429",42,1,143,118,6044170,6051166,6996,"reading"
"18529",42,1,142,119,6053654,6063533,9879,"reading"
"18626",42,1,134,120,6065424,6072400,6976,"reading"
"18736",42,2,151,121,6074667,6084850,10183,"reading"
"18936",42,2,152,122,6089848,6103835,13987,"reading"
"19139",42,2,153,123,6109981,6116085,6104,"reading"
"19334",42,3,120,124,6121142,6129602,8460,"reading"
"19427",42,3,101,125,6131726,6138286,6560,"reading"
"19628",42,3,114,126,6144654,6156769,12115,"reading"
"19732",42,3,96,127,6158486,6164086,5600,"reading"
"19927",42,3,104,128,6170953,6178604,7651,"reading"
"20034",42,3,117,129,6181805,6187670,5865,"reading"
"20134",42,2,159,130,6189634,6198671,9037,"reading"
"20324",42,2,175,131,6205297,6210171,4874,"reading"
"20432",42,2,155,132,6258426,6267573,9147,"reading"
"20632",42,2,161,133,6275482,6282174,6692,"reading"
"20829",42,3,110,134,6288766,6293091,4325,"reading"
"20933",42,2,163,135,6296012,6305808,9796,"reading"
"21030",42,3,119,136,6307962,6316808,8846,"reading"
"21139",42,3,102,137,6319143,6326408,7265,"reading"
"21329",42,3,115,138,6332784,6339776,6992,"reading"
"21428",42,3,97,139,6342231,6348359,6128,"reading"
"21628",42,3,98,140,6353694,6361343,7649,"reading"
"21829",42,2,171,141,6366654,6374494,7840,"reading"
"21931",42,3,113,142,6376658,6382410,5752,"reading"
"22028",42,2,180,143,6384458,6392227,7769,"reading"
"22143",42,3,118,144,6394791,6404661,9870,"reading"
"22232",42,3,94,145,6406562,6414845,8283,"reading"
"22431",42,2,172,146,6421661,6431912,10251,"reading"
"22528",42,3,107,147,6433480,6438429,4949,"reading"
"22626",42,2,165,148,6440307,6447696,7389,"reading"
"22729",42,2,176,149,6450294,6457898,7604,"reading"
"22832",42,2,162,150,6459988,6466097,6109,"reading"
"23028",42,2,168,151,6471766,6478530,6764,"reading"
"23143",42,3,95,152,6480499,6486080,5581,"reading"
"23335",42,2,154,153,6491795,6497531,5736,"reading"
"23528",42,3,92,154,6503778,6511481,7703,"reading"
"23727",42,2,169,155,6516578,6523565,6987,"reading"
"23831",42,3,106,156,6526020,6531932,5912,"reading"
"23926",42,2,178,157,6534186,6541599,7413,"reading"
"24030",42,3,91,158,6543406,6552766,9360,"reading"
"24228",42,2,179,159,6558632,6563083,4451,"reading"
"24332",42,2,174,160,6565500,6574600,9100,"reading"
"24431",42,2,158,161,6576751,6582467,5716,"reading"
"24630",42,3,103,162,6587881,6595734,7853,"reading"
"24728",42,2,164,163,6598486,6605068,6582,"reading"
"24829",42,2,156,164,6606835,6616319,9484,"reading"
"25029",42,2,177,165,6623100,6629185,6085,"reading"
"25135",42,3,109,166,6631278,6636402,5124,"reading"
"25230",42,2,157,167,6638409,6646886,8477,"reading"
"25426",42,3,99,168,6652263,6660253,7990,"reading"
"25630",42,3,105,169,6666323,6672237,5914,"reading"
"25733",42,2,166,170,6674015,6682887,8872,"reading"
"25831",42,2,160,171,6684901,6690704,5803,"reading"
"26033",42,3,111,172,6697959,6705638,7679,"reading"
"26134",42,3,108,173,6707588,6714739,7151,"reading"
"26232",42,2,170,174,6716569,6724139,7570,"reading"
"26331",42,3,116,175,6726687,6732956,6269,"reading"
"26426",42,3,100,176,6735121,6740873,5752,"reading"
"26629",42,3,112,177,6746056,6750940,4884,"reading"
"26728",42,3,93,178,6752653,6758490,5837,"reading"
"26924",42,2,173,179,6763511,6768807,5296,"reading"
"27035",42,2,167,180,6770773,6780224,9451,"reading"
"10147",43,2,31,1,4507878,4516776,8898,"reading"
"12140",43,2,32,2,4522375,4528326,5951,"reading"
"1442",43,2,33,3,4535495,4541944,6449,"reading"
"16140",43,2,59,4,4546953,4551078,4125,"reading"
"17138",43,3,70,5,4553164,4564846,11682,"reading"
"19140",43,2,36,6,4571530,4575361,3831,"reading"
"21140",43,2,53,7,4580266,4587778,7512,"reading"
"22144",43,3,74,8,4589745,4597096,7351,"reading"
"23144",43,2,49,9,4598867,4604762,5895,"reading"
"24134",43,3,65,10,4606960,4614163,7203,"reading"
"26135",43,2,43,11,4620607,4626730,6123,"reading"
"2747",43,3,90,12,4628245,4633197,4952,"reading"
"2824",43,3,61,13,4634949,4643280,8331,"reading"
"3032",43,2,45,14,4650526,4656814,6288,"reading"
"3132",43,3,66,15,4658755,4668581,9826,"reading"
"3331",43,3,69,16,4674352,4681265,6913,"reading"
"3534",43,2,42,17,4686637,4694865,8228,"reading"
"3736",43,3,84,18,4701764,4711368,9604,"reading"
"3825",43,3,79,19,4712810,4719916,7106,"reading"
"3932",43,3,64,20,4721675,4726816,5141,"reading"
"4132",43,2,47,21,4736971,4746051,9080,"reading"
"4229",43,3,82,22,4747863,4753534,5671,"reading"
"4334",43,2,57,23,4755897,4763084,7187,"reading"
"4430",43,2,50,24,4764668,4769751,5083,"reading"
"4533",43,2,52,25,4772995,4778369,5374,"reading"
"4627",43,3,63,26,4780238,4784502,4264,"reading"
"4825",43,3,83,27,4789965,4794602,4637,"reading"
"4933",43,3,73,28,4796006,4802252,6246,"reading"
"5029",43,2,48,29,4803994,4810919,6925,"reading"
"5125",43,2,60,30,4813045,4819386,6341,"reading"
"5235",43,3,67,31,4821199,4827903,6704,"reading"
"5432",43,3,85,32,4833849,4843904,10055,"reading"
"5516",43,2,51,33,4845737,4852371,6634,"reading"
"5632",43,2,44,34,4854085,4857271,3186,"reading"
"5719",43,2,54,35,4858639,4861954,3315,"reading"
"5831",43,2,35,36,4863428,4868155,4727,"reading"
"6034",43,2,41,37,4877081,4882422,5341,"reading"
"6224",43,2,46,38,4887917,4894922,7005,"reading"
"6333",43,2,55,39,4899020,4904039,5019,"reading"
"6431",43,3,68,40,4905793,4912056,6263,"reading"
"6631",43,2,40,41,4917654,4922056,4402,"reading"
"6832",43,3,72,42,5065110,5072698,7588,"reading"
"7031",43,2,37,43,5078134,5082730,4596,"reading"
"7229",43,3,75,44,5089576,5095863,6287,"reading"
"7332",43,3,62,45,5097913,5105814,7901,"reading"
"7533",43,2,39,46,5110072,5114498,4426,"reading"
"7729",43,3,86,47,5119337,5126798,7461,"reading"
"7828",43,3,78,48,5128268,5137082,8814,"reading"
"7935",43,3,87,49,5138628,5146098,7470,"reading"
"8029",43,3,71,50,5147865,5153349,5484,"reading"
"8229",43,2,56,51,5159786,5164266,4480,"reading"
"8333",43,3,89,52,5166149,5172785,6636,"reading"
"8430",43,2,38,53,5174676,5182650,7974,"reading"
"8627",43,3,76,54,5187878,5192450,4572,"reading"
"8731",43,3,88,55,5194527,5204301,9774,"reading"
"8830",43,3,81,56,5206020,5214434,8414,"reading"
"8933",43,2,58,57,5216526,5224018,7492,"reading"
"9033",43,3,80,58,5225668,5231501,5833,"reading"
"9135",43,3,77,59,5233056,5233220,164,"reading"
"9227",43,2,34,60,5238239,5244452,6213,"reading"
"9435",43,1,19,61,5249756,5257352,7596,"reading"
"9535",43,1,16,62,5258833,5265636,6803,"reading"
"9631",43,1,15,63,5267176,5273770,6594,"reading"
"9728",43,1,23,64,5275197,5281270,6073,"reading"
"9832",43,1,28,65,5283442,5289337,5895,"reading"
"9930",43,1,3,66,5290950,5297988,7038,"reading"
"10148",43,1,12,67,5303675,5310404,6729,"reading"
"10329",43,1,25,68,5316198,5324888,8690,"reading"
"10430",43,1,8,69,5326424,5333589,7165,"reading"
"10633",43,1,1,70,5340920,5345539,4619,"reading"
"10832",43,1,6,71,5350630,5357156,6526,"reading"
"11029",43,1,11,72,5363240,5369873,6633,"reading"
"11225",43,1,30,73,5376909,5381673,4764,"reading"
"11331",43,1,20,74,5383464,5392724,9260,"reading"
"11429",43,1,14,75,5394228,5399976,5748,"reading"
"11523",43,1,24,76,5401871,5408208,6337,"reading"
"11631",43,1,17,77,5409848,5416908,7060,"reading"
"11729",43,1,29,78,5418557,5423191,4634,"reading"
"11827",43,1,27,79,5425320,5433842,8522,"reading"
"11927",43,1,7,80,5435610,5440758,5148,"reading"
"12141",43,1,4,81,5447421,5455926,8505,"reading"
"12329",43,1,21,82,5461754,5470010,8256,"reading"
"12429",43,1,13,83,5471625,5477626,6001,"reading"
"12530",43,1,26,84,5479247,5486627,7380,"reading"
"12631",43,1,2,85,5488717,5494911,6194,"reading"
"12831",43,1,10,86,5501235,5507878,6643,"reading"
"13035",43,1,18,87,5514032,5520245,6213,"reading"
"13125",43,1,22,88,5521885,5528712,6827,"reading"
"13235",43,1,5,89,5530300,5538578,8278,"reading"
"13428",43,1,9,90,5543255,5548912,5657,"reading"
"14535",43,2,121,91,5768619,5771870,3251,"zString"
"14734",43,2,122,92,5776048,5780336,4288,"zString"
"14934",43,2,123,93,5784422,5790203,5781,"zString"
"15136",43,3,166,94,5794544,5802687,8143,"zString"
"15232",43,3,154,95,5804276,5809405,5129,"zString"
"15433",43,2,135,96,5813889,5819488,5599,"zString"
"15531",43,3,170,97,5821239,5826238,4999,"zString"
"15631",43,2,129,98,5827670,5832339,4669,"zString"
"15825",43,3,152,99,5837400,5842805,5405,"zString"
"16027",43,2,150,100,5847865,5854439,6574,"zString"
"16141",43,2,137,101,5856101,5862740,6639,"zString"
"16234",43,2,128,102,5864704,5872073,7369,"zString"
"16434",43,2,125,103,5876217,5882924,6707,"zString"
"16630",43,3,168,104,5889262,5895290,6028,"zString"
"16731",43,3,174,105,5897983,5903957,5974,"zString"
"16830",43,3,179,106,5905668,5913775,8107,"zString"
"16930",43,3,167,107,5916307,5921925,5618,"zString"
"17029",43,3,162,108,5923815,5929459,5644,"zString"
"17232",43,3,158,109,5933429,5939842,6413,"zString"
"17430",43,3,175,110,5943728,5949376,5648,"zString"
"17529",43,2,127,111,5951447,5959209,7762,"zString"
"17731",43,3,160,112,5964323,5971193,6870,"zString"
"17933",43,3,165,113,5976466,5980694,4228,"zString"
"18032",43,3,153,114,5982732,5988744,6012,"zString"
"18235",43,2,145,115,5992632,5997511,4879,"zString"
"18325",43,2,143,116,5999224,6006094,6870,"zString"
"18430",43,2,130,117,6008208,6014645,6437,"zString"
"18627",43,3,156,118,6019377,6028229,8852,"zString"
"18813",43,2,136,119,6033254,6038496,5242,"zString"
"18937",43,2,124,120,6040188,6045131,4943,"zString"
"19141",43,2,149,121,6049882,6056212,6330,"zString"
"19223",43,2,147,122,6058428,6065197,6769,"zString"
"19335",43,2,133,123,6067253,6074764,7511,"zString"
"19428",43,3,176,124,6077119,6084447,7328,"zString"
"19532",43,3,151,125,6087873,6094997,7124,"zString"
"19733",43,2,142,126,6099991,6105948,5957,"zString"
"19829",43,3,173,127,6108638,6113982,5344,"zString"
"19928",43,2,131,128,6115992,6121348,5356,"zString"
"20135",43,2,148,129,6125599,6134216,8617,"zString"
"20230",43,2,146,130,6136259,6141616,5357,"zString"
"20325",43,3,164,131,6143325,6149966,6641,"zString"
"20433",43,3,169,132,6307324,6312805,5481,"zString"
"20528",43,2,140,133,6314445,6318572,4127,"zString"
"20633",43,2,144,134,6320115,6324572,4457,"zString"
"20733",43,2,138,135,6326191,6330706,4515,"zString"
"20830",43,3,161,136,6332332,6337039,4707,"zString"
"21031",43,2,141,137,6342018,6346089,4071,"zString"
"21141",43,3,177,138,6347776,6356523,8747,"zString"
"21228",43,3,163,139,6358684,6362841,4157,"zString"
"21330",43,3,180,140,6364939,6369523,4584,"zString"
"21429",43,3,155,141,6371188,6376707,5519,"zString"
"21629",43,3,159,142,6381801,6386423,4622,"zString"
"21830",43,2,134,143,6392533,6400075,7542,"zString"
"21932",43,2,132,144,6402271,6407342,5071,"zString"
"22145",43,3,172,145,6411758,6418241,6483,"zString"
"22233",43,3,178,146,6420788,6425475,4687,"zString"
"22333",43,3,171,147,6427252,6432076,4824,"zString"
"22432",43,2,139,148,6433954,6439942,5988,"zString"
"22529",43,2,126,149,6441668,6447343,5675,"zString"
"22730",43,3,157,150,6455778,6460277,4499,"zString"
"22931",43,1,92,151,6464341,6469776,5435,"zString"
"23145",43,1,119,152,6474427,6481477,7050,"zString"
"23228",43,1,117,153,6483195,6488294,5099,"zString"
"23336",43,1,114,154,6490274,6494811,4537,"zString"
"23433",43,1,103,155,6496965,6503746,6781,"zString"
"23529",43,1,99,156,6505652,6510228,4576,"zString"
"23728",43,1,96,157,6515270,6520979,5709,"zString"
"23927",43,1,110,158,6525461,6529712,4251,"zString"
"24031",43,1,95,159,6531651,6538045,6394,"zString"
"24229",43,1,113,160,6542009,6547563,5554,"zString"
"24333",43,1,105,161,6551422,6555346,3924,"zString"
"24432",43,1,97,162,6557175,6562280,5105,"zString"
"24631",43,1,111,163,6566959,6572264,5305,"zString"
"24729",43,1,94,164,6573888,6578797,4909,"zString"
"24930",43,1,118,165,6583082,6587814,4732,"zString"
"25030",43,1,98,166,6589584,6593814,4230,"zString"
"25231",43,1,93,167,6597832,6601448,3616,"zString"
"25427",43,1,107,168,6605341,6610481,5140,"zString"
"25530",43,1,100,169,6612147,6617716,5569,"zString"
"25734",43,1,101,170,6621658,6626049,4391,"zString"
"25927",43,1,120,171,6630099,6635398,5299,"zString"
"26034",43,1,106,172,6636972,6643033,6061,"zString"
"26136",43,1,108,173,6644778,6652133,7355,"zString"
"26233",43,1,116,174,6653767,6658700,4933,"zString"
"26332",43,1,91,175,6660713,6667000,6287,"zString"
"26528",43,1,104,176,6674101,6679901,5800,"zString"
"26630",43,1,109,177,6681773,6685951,4178,"zString"
"26729",43,1,115,178,6687645,6691834,4189,"zString"
"26834",43,1,102,179,6696237,6702618,6381,"zString"
"27036",43,1,112,180,6707620,6715353,7733,"zString"
"1190",44,2,1,1,7799911,7803071,3160,"zString"
"1372",44,2,2,2,7806818,7809155,2337,"zString"
"15103",44,2,3,3,7813044,7815356,2312,"zString"
"17139",44,2,12,4,7819998,7822472,2474,"zString"
"19142",44,3,31,5,7826768,7829806,3038,"zString"
"21142",44,2,4,6,7834544,7837173,2629,"zString"
"23146",44,3,47,7,7841120,7844573,3453,"zString"
"24135",44,3,37,8,7846754,7849256,2502,"zString"
"26137",44,3,52,9,7854400,7857240,2840,"zString"
"2748",44,3,60,10,7859164,7862207,3043,"zString"
"2825",44,2,20,11,7864475,7867807,3332,"zString"
"2935",44,2,21,12,7870610,7872957,2347,"zString"
"3033",44,3,49,13,7874547,7876974,2427,"zString"
"3133",44,3,34,14,7879178,7881825,2647,"zString"
"3332",44,2,23,15,7887061,7890341,3280,"zString"
"3428",44,3,41,16,7893177,7895625,2448,"zString"
"3626",44,2,16,17,7899898,7903025,3127,"zString"
"3737",44,3,59,18,7905256,7908625,3369,"zString"
"3826",44,2,18,19,7910141,7912709,2568,"zString"
"3933",44,3,55,20,7915574,7918109,2535,"zString"
"4030",44,2,15,21,7923866,7927259,3393,"zString"
"4133",44,3,50,22,7930412,7934476,4064,"zString"
"4230",44,3,38,23,7937717,7940626,2909,"zString"
"4431",44,2,17,24,7945529,7949243,3714,"zString"
"4534",44,3,32,25,7951082,7954960,3878,"zString"
"4732",44,2,7,26,7959655,7963077,3422,"zString"
"4934",44,3,42,27,7967707,7970561,2854,"zString"
"5126",44,3,51,28,7974975,7977828,2853,"zString"
"5236",44,2,26,29,7981758,7985478,3720,"zString"
"5320",44,2,27,30,7988060,7992028,3968,"zString"
"5433",44,2,13,31,7993975,7996795,2820,"zString"
"5517",44,2,5,32,7998831,8003945,5114,"zString"
"5720",44,2,22,33,8008716,8013528,4812,"zString"
"5832",44,3,53,34,8016169,8020662,4493,"zString"
"5931",44,2,11,35,8025025,8031563,6538,"zString"
"6131",44,2,30,36,8035863,8041447,5584,"zString"
"6225",44,3,58,37,8043693,8049597,5904,"zString"
"6334",44,3,33,38,8051527,8054314,2787,"zString"
"6530",44,3,43,39,8059542,8063297,3755,"zString"
"6632",44,2,14,40,8066757,8069631,2874,"zString"
"6731",44,2,19,41,8071891,8075781,3890,"zString"
"6833",44,2,29,42,8237943,8241187,3244,"zString"
"6933",44,3,45,43,8242962,8245870,2908,"zString"
"7032",44,3,56,44,8247400,8250370,2970,"zString"
"7133",44,3,57,45,8252201,8255137,2936,"zString"
"7230",44,2,10,46,8256521,8258920,2399,"zString"
"7431",44,3,54,47,8262713,8265204,2491,"zString"
"7534",44,3,48,48,8266909,8270538,3629,"zString"
"7632",44,3,36,49,8272194,8275205,3011,"zString"
"7829",44,2,8,50,8279396,8282555,3159,"zString"
"8030",44,3,35,51,8289107,8292072,2965,"zString"
"8230",44,2,25,52,8295630,8298789,3159,"zString"
"8334",44,2,24,53,8300249,8303305,3056,"zString"
"8431",44,3,39,54,8305230,8308806,3576,"zString"
"8628",44,3,44,55,8312376,8315139,2763,"zString"
"8732",44,2,9,56,8316738,8319239,2501,"zString"
"8934",44,2,6,57,8322833,8325873,3040,"zString"
"9136",44,3,46,58,8329341,8332289,2948,"zString"
"9228",44,2,28,59,8333827,8337606,3779,"zString"
"9330",44,3,40,60,8339230,8341873,2643,"zString"
"9536",44,1,83,61,8345588,8348607,3019,"zString"
"9632",44,1,87,62,8350132,8352774,2642,"zString"
"9729",44,1,63,63,8354323,8357024,2701,"zString"
"9931",44,1,71,64,8361633,8364508,2875,"zString"
"10149",44,1,88,65,8368536,8371575,3039,"zString"
"10237",44,1,89,66,8373721,8376958,3237,"zString"
"10330",44,1,67,67,8378708,8381108,2400,"zString"
"10531",44,1,77,68,8384532,8387008,2476,"zString"
"10634",44,1,70,69,8389169,8391425,2256,"zString"
"10833",44,1,78,70,8395366,8398009,2643,"zString"
"10928",44,1,66,71,8400146,8402509,2363,"zString"
"11133",44,1,86,72,8406666,8408559,1893,"zString"
"11226",44,1,73,73,8410067,8411926,1859,"zString"
"11332",44,1,90,74,8413914,8416659,2745,"zString"
"11430",44,1,62,75,8418296,8421026,2730,"zString"
"11632",44,1,61,76,8425690,8428460,2770,"zString"
"11828",44,1,69,77,8432426,8435277,2851,"zString"
"12037",44,1,82,78,8439603,8442760,3157,"zString"
"12142",44,1,72,79,8444265,8447444,3179,"zString"
"12330",44,1,76,80,8450931,8454577,3646,"zString"
"12430",44,1,65,81,8458238,8461378,3140,"zString"
"12632",44,1,84,82,8464850,8468878,4028,"zString"
"12733",44,1,75,83,8470875,8473778,2903,"zString"
"12832",44,1,85,84,8475434,8478078,2644,"zString"
"12924",44,1,79,85,8479499,8481611,2112,"zString"
"13036",44,1,64,86,8483044,8486045,3001,"zString"
"13236",44,1,68,87,8492042,8495696,3654,"zString"
"13429",44,1,80,88,8499795,8503862,4067,"zString"
"13529",44,1,81,89,8505456,8508862,3406,"zString"
"13610",44,1,74,90,8510295,8514663,4368,"zString"
"14610",44,2,91,91,8746971,8751823,4852,"reading"
"14818",44,2,92,92,8759823,8765106,5283,"reading"
"15016",44,2,93,93,8770898,8775273,4375,"reading"
"15233",44,3,134,94,8781649,8785557,3908,"reading"
"15326",44,2,97,95,8787585,8792057,4472,"reading"
"15532",44,3,122,96,8797937,8803224,5287,"reading"
"15732",44,3,121,97,8808348,8811691,3343,"reading"
"15933",44,2,98,98,8817643,8822375,4732,"reading"
"16235",44,2,103,100,8848159,8853959,5800,"reading"
"16328",44,3,140,101,8855762,8859360,3598,"reading"
"16435",44,2,109,102,8860871,8864426,3555,"reading"
"16530",44,2,111,103,8866666,8870343,3677,"reading"
"16631",44,2,118,104,8872155,8876560,4405,"reading"
"16732",44,3,126,105,8878199,8881493,3294,"reading"
"16931",44,2,100,106,8886218,8889894,3676,"reading"
"17140",44,2,115,107,8894093,8898244,4151,"reading"
"17233",44,2,94,108,8899877,8904028,4151,"reading"
"17431",44,3,142,109,8908870,8913728,4858,"reading"
"17530",44,3,145,110,8915933,8920312,4379,"reading"
"17630",44,3,123,111,8922018,8927662,5644,"reading"
"17827",44,3,127,112,8931865,8936695,4830,"reading"
"18033",44,3,136,113,8943341,8947979,4638,"reading"
"18130",44,2,120,114,8949507,8954946,5439,"reading"
"18236",44,3,125,115,8957364,8961863,4499,"reading"
"18431",44,3,139,116,8967954,8971513,3559,"reading"
"18530",44,3,143,117,8972923,8977397,4474,"reading"
"18628",44,3,147,118,8979164,8982097,2933,"reading"
"18737",44,3,124,119,8984106,8989364,5258,"reading"
"18938",44,2,105,120,8995165,8998781,3616,"reading"
"19021",44,2,119,121,9000443,9004881,4438,"reading"
"19143",44,2,113,122,9006534,9010731,4197,"reading"
"19224",44,2,104,123,9012598,9017332,4734,"reading"
"19336",44,3,128,124,9019219,9023532,4313,"reading"
"19533",44,3,144,125,9029991,9034815,4824,"reading"
"19629",44,3,149,126,9036723,9041566,4843,"reading"
"19734",44,3,130,127,9043401,9048316,4915,"reading"
"19929",44,2,116,128,9052986,9057316,4330,"reading"
"20035",44,3,135,129,9059201,9064000,4799,"reading"
"20136",44,2,101,130,9065842,9069433,3591,"reading"
"20326",44,2,108,131,9074986,9079718,4732,"reading"
"20434",44,3,132,132,9082647,9087734,5087,"reading"
"20634",44,2,106,133,9364058,9369429,5371,"reading"
"20734",44,3,150,134,9371159,9375879,4720,"reading"
"20831",44,3,137,135,9382308,9386529,4221,"reading"
"20934",44,2,99,136,9389248,9395147,5899,"reading"
"21143",44,2,114,137,9403833,9408997,5164,"reading"
"21229",44,2,95,138,9411811,9416131,4320,"reading"
"21430",44,3,146,139,9422549,9427181,4632,"reading"
"21530",44,3,131,140,9428691,9432714,4023,"reading"
"21732",44,3,129,141,9440396,9445581,5185,"reading"
"21933",44,3,138,142,9452083,9456232,4149,"reading"
"22029",44,2,107,143,9458101,9461982,3881,"reading"
"22146",44,3,133,144,9463964,9469049,5085,"reading"
"22234",44,2,112,145,9470884,9475299,4415,"reading"
"22334",44,2,96,146,9476828,9481716,4888,"reading"
"22530",44,2,117,147,9489864,9495250,5386,"reading"
"22627",44,3,141,148,9497137,9502934,5797,"reading"
"22833",44,3,148,150,9530718,9537318,6600,"reading"
"22932",44,2,110,151,9539178,9542351,3173,"reading"
"23029",44,2,102,152,9544337,9547518,3181,"reading"
"23229",44,1,173,153,9556226,9561519,5293,"reading"
"23337",44,1,174,154,9563215,9568552,5337,"reading"
"23434",44,1,162,155,9570994,9575486,4492,"reading"
"23630",44,1,160,156,9583036,9587970,4934,"reading"
"23832",44,1,179,157,9595008,9598987,3979,"reading"
"23928",44,1,161,158,9600769,9606571,5802,"reading"
"24136",44,1,169,159,9613344,9618838,5494,"reading"
"24230",44,1,171,160,9620665,9625388,4723,"reading"
"24334",44,1,168,161,9627128,9632154,5026,"reading"
"24433",44,1,163,162,9639750,9644038,4288,"reading"
"24533",44,1,164,163,9647293,9652539,5246,"reading"
"24632",44,1,158,164,9654403,9660373,5970,"reading"
"24830",44,1,172,165,9667459,9672073,4614,"reading"
"24931",44,1,175,166,9673821,9679206,5385,"reading"
"25031",44,1,151,167,9680937,9687656,6719,"reading"
"25232",44,1,157,168,9695562,9699823,4261,"reading"
"25428",44,1,165,169,9704638,9708740,4102,"reading"
"25531",44,1,159,170,9711036,9715991,4955,"reading"
"25735",44,1,178,171,9724706,9729874,5168,"reading"
"25832",44,1,155,172,9732832,9738758,5926,"reading"
"26035",44,1,180,173,9745202,9750225,5023,"reading"
"26138",44,1,177,174,9752084,9757575,5491,"reading"
"26234",44,1,153,175,9759834,9763642,3808,"reading"
"26427",44,1,170,176,9770425,9774859,4434,"reading"
"26529",44,1,156,177,9776666,9782309,5643,"reading"
"26730",44,1,176,178,9789173,9792010,2837,"reading"
"26835",44,1,167,179,9793878,9798010,4132,"reading"
"26925",44,1,154,180,9799651,9803727,4076,"reading"
"27112",44,1,152,181,9809936,9815194,5258,"reading"
"27310",44,1,166,182,9822346,9829544,7198,"reading"
"10150",45,1,60,1,11471801,11474334,2533,"reading"
"11100",45,1,57,2,11476088,11478767,2679,"reading"
"12143",45,1,55,3,11480292,11482484,2192,"reading"
"1373",45,1,51,4,11484117,11487668,3551,"reading"
"1443",45,1,44,5,11489043,11491884,2841,"reading"
"15104",45,1,43,6,11493446,11496351,2905,"reading"
"16142",45,1,48,7,11498034,11501735,3701,"reading"
"17141",45,1,49,8,11503219,11506351,3132,"reading"
"18109",45,1,59,9,11507840,11510068,2228,"reading"
"19144",45,1,40,10,11511535,11514302,2767,"reading"
"21144",45,1,42,11,11521157,11525135,3978,"reading"
"23147",45,1,56,12,11530636,11534202,3566,"reading"
"24137",45,1,53,13,11535799,11539203,3404,"reading"
"25136",45,1,32,14,11540890,11543319,2429,"reading"
"2749",45,1,52,15,11548988,11552453,3465,"reading"
"2826",45,1,37,16,11553981,11557053,3072,"reading"
"3034",45,1,47,17,11561717,11566653,4936,"reading"
"3134",45,1,39,18,11568336,11571470,3134,"reading"
"3333",45,1,50,19,11579050,11582671,3621,"reading"
"3429",45,1,34,20,11584302,11588371,4069,"reading"
"3627",45,1,54,21,11593730,11596088,2358,"reading"
"3738",45,1,31,22,11597718,11600821,3103,"reading"
"3934",45,1,33,23,11605138,11608205,3067,"reading"
"4134",45,1,45,24,11613493,11616305,2812,"reading"
"4231",45,1,41,25,11617834,11620405,2571,"reading"
"4432",45,1,58,26,11625443,11629706,4263,"reading"
"4535",45,1,36,27,11631591,11634489,2898,"reading"
"4733",45,1,46,28,11639177,11642740,3563,"reading"
"4826",45,1,38,29,11644513,11648956,4443,"reading"
"5030",45,1,35,30,11653732,11656673,2941,"reading"
"5237",45,2,61,31,11660771,11663707,2936,"reading"
"5434",45,2,62,32,11667542,11670024,2482,"reading"
"5633",45,2,63,33,11673689,11677474,3785,"reading"
"5833",45,3,6,34,11685106,11688441,3335,"reading"
"6035",45,3,2,35,11692829,11696391,3562,"reading"
"6226",45,3,29,36,11700864,11704141,3277,"reading"
"6335",45,2,64,37,11706228,11709358,3130,"reading"
"6531",45,2,79,38,11717848,11723709,5861,"reading"
"6633",45,3,7,39,11725372,11730592,5220,"reading"
"6834",45,2,75,40,11735202,11738659,3457,"reading"
"6934",45,2,81,41,11740127,11743743,3616,"reading"
"7033",45,3,24,42,11927590,11930916,3326,"reading"
"7134",45,3,21,43,11932802,11936032,3230,"reading"
"7231",45,3,3,44,11937763,11941050,3287,"reading"
"7432",45,3,13,45,11945628,11949516,3888,"reading"
"7535",45,2,84,46,11951227,11955417,4190,"reading"
"7633",45,3,18,47,11956976,11960683,3707,"reading"
"7730",45,2,83,48,11962328,11965467,3139,"reading"
"7830",45,3,26,49,11967567,11971017,3450,"reading"
"7936",45,2,65,50,11972476,11976117,3641,"reading"
"8129",45,2,66,51,11983060,11986034,2974,"reading"
"8335",45,3,10,52,11990320,11993535,3215,"reading"
"8530",45,3,16,53,11998042,12001302,3260,"reading"
"8629",45,2,74,54,12002882,12006035,3153,"reading"
"8733",45,3,20,55,12008471,12011969,3498,"reading"
"8831",45,2,77,56,12014123,12017852,3729,"reading"
"8935",45,2,76,57,12019912,12023236,3324,"reading"
"9034",45,2,88,58,12025636,12029352,3716,"reading"
"9137",45,2,73,59,12030884,12034503,3619,"reading"
"9229",45,3,22,60,12036279,12040270,3991,"reading"
"9331",45,3,17,61,12041789,12045703,3914,"reading"
"9436",45,3,9,62,12048292,12051820,3528,"reading"
"9633",45,3,27,63,12056454,12060870,4416,"reading"
"9730",45,3,19,64,12062719,12067054,4335,"reading"
"9833",45,3,25,65,12069041,12072088,3047,"reading"
"9932",45,2,89,66,12073996,12076621,2625,"reading"
"10030",45,2,69,67,12078124,12081371,3247,"reading"
"10238",45,2,70,68,12085863,12089355,3492,"reading"
"10431",45,2,78,69,12100685,12106322,5637,"reading"
"10532",45,3,8,70,12107910,12111905,3995,"reading"
"10729",45,2,80,71,12116391,12120772,4381,"reading"
"10834",45,3,4,72,12122403,12125839,3436,"reading"
"11030",45,2,86,73,12133502,12138256,4754,"reading"
"11134",45,3,23,74,12139919,12144957,5038,"reading"
"11227",45,3,28,75,12146544,12149790,3246,"reading"
"11333",45,2,72,76,12151285,12154690,3405,"reading"
"11524",45,3,1,77,12160116,12164024,3908,"reading"
"11730",45,2,85,78,12168397,12172357,3960,"reading"
"11829",45,2,90,79,12173996,12177324,3328,"reading"
"11928",45,2,87,80,12178969,12182592,3623,"reading"
"12038",45,3,15,81,12184944,12188991,4047,"reading"
"12144",45,3,12,82,12191250,12194925,3675,"reading"
"12331",45,3,30,83,12199821,12204192,4371,"reading"
"12431",45,3,11,84,12205872,12209375,3503,"reading"
"12633",45,3,5,85,12214219,12217659,3440,"reading"
"12833",45,3,14,86,12222029,12224809,2780,"reading"
"12925",45,2,71,87,12226379,12229909,3530,"reading"
"13126",45,2,67,88,12235332,12239960,4628,"reading"
"13334",45,2,82,89,12248300,12255160,6860,"reading"
"13430",45,2,68,90,12256819,12260460,3641,"reading"
"14536",45,1,133,91,12495468,12500352,4884,"zString"
"14611",45,1,144,92,12502153,12508835,6682,"zString"
"14735",45,1,135,93,12510487,12515136,4649,"zString"
"14819",45,1,142,94,12517045,12521919,4874,"zString"
"14935",45,1,124,95,12524188,12529736,5548,"zString"
"15137",45,1,122,96,12534907,12541653,6746,"zString"
"15327",45,1,137,97,12546672,12551720,5048,"zString"
"15434",45,1,148,98,12553741,12559770,6029,"zString"
"15533",45,1,139,99,12561567,12562054,487,"zString"
"15632",45,1,147,100,12565169,12571471,6302,"zString"
"15733",45,1,146,101,12573418,12578838,5420,"zString"
"15826",45,1,130,102,12580471,12585288,4817,"zString"
"16028",45,1,143,103,12589565,12595638,6073,"zString"
"16143",45,1,127,104,12597170,12602555,5385,"zString"
"16329",45,1,138,105,12607212,12612322,5110,"zString"
"16436",45,1,129,106,12614075,12617689,3614,"zString"
"16632",45,1,121,107,12621776,12625289,3513,"zString"
"16831",45,1,145,108,12628951,12632623,3672,"zString"
"16932",45,1,140,109,12634291,12640140,5849,"zString"
"17030",45,1,126,110,12641878,12646440,4562,"zString"
"17234",45,1,125,111,12650538,12654724,4186,"zString"
"17432",45,1,123,112,12660595,12665824,5229,"zString"
"17631",45,1,131,113,12669557,12674825,5268,"zString"
"17828",45,1,141,114,12678429,12682725,4296,"zString"
"17934",45,1,150,115,12684672,12690442,5770,"zString"
"18034",45,1,136,116,12692201,12697375,5174,"zString"
"18131",45,1,128,117,12699286,12704642,5356,"zString"
"18326",45,1,132,118,12708692,12713409,4717,"zString"
"18531",45,1,149,119,12717361,12722459,5098,"zString"
"18629",45,1,134,120,12724787,12729010,4223,"zString"
"18738",45,2,151,121,12730601,12734593,3992,"zString"
"18939",45,2,152,122,12739269,12743377,4108,"zString"
"19145",45,2,153,123,12747360,12751577,4217,"zString"
"19337",45,2,160,124,12755463,12760361,4898,"zString"
"19534",45,2,155,125,12763994,12767411,3417,"zString"
"19735",45,2,168,126,12771227,12776011,4784,"zString"
"19830",45,3,100,127,12777842,12782628,4786,"zString"
"20036",45,3,113,128,12787660,12791845,4185,"zString"
"20137",45,3,96,129,12793729,12798062,4333,"zString"
"20327",45,3,102,130,12801711,12805329,3618,"zString"
"20529",45,3,114,131,12809772,12813262,3490,"zString"
"20635",45,2,166,132,12974822,12979603,4781,"zString"
"20735",45,3,101,133,12981322,12984504,3182,"zString"
"20935",45,3,95,134,12988210,12992470,4260,"zString"
"21145",45,2,164,135,12996435,13000837,4402,"zString"
"21230",45,3,115,136,13003053,13006154,3101,"zString"
"21331",45,2,158,137,13007782,13010837,3055,"zString"
"21531",45,2,176,138,13014435,13019188,4753,"zString"
"21630",45,2,173,139,13021034,13024405,3371,"zString"
"21733",45,2,175,140,13025727,13029555,3828,"zString"
"21831",45,2,170,141,13031010,13034671,3661,"zString"
"21934",45,3,106,142,13037085,13041589,4504,"zString"
"22030",45,2,154,143,13043064,13046056,2992,"zString"
"22235",45,3,108,144,13050359,13054606,4247,"zString"
"22335",45,3,112,145,13056165,13060023,3858,"zString"
"22433",45,2,180,146,13061825,13066556,4731,"zString"
"22531",45,3,92,147,13068335,13071890,3555,"zString"
"22731",45,2,178,148,13076147,13079223,3076,"zString"
"22834",45,2,177,149,13081135,13084507,3372,"zString"
"22933",45,2,171,150,13086915,13090790,3875,"zString"
"23030",45,2,156,151,13092364,13096541,4177,"zString"
"23230",45,2,169,152,13100325,13103541,3216,"zString"
"23338",45,2,167,153,13105094,13109541,4447,"zString"
"23435",45,3,97,154,13111010,13113158,2148,"zString"
"23631",45,3,104,155,13116838,13120858,4020,"zString"
"23729",45,2,174,156,13122465,13126658,4193,"zString"
"23833",45,2,172,157,13128886,13133625,4739,"zString"
"23929",45,2,161,158,13135394,13139908,4514,"zString"
"24138",45,3,110,159,13144219,13147375,3156,"zString"
"24231",45,3,93,160,13149924,13154209,4285,"zString"
"24434",45,2,163,161,13157949,13162859,4910,"zString"
"24534",45,2,157,162,13164600,13168410,3810,"zString"
"24730",45,3,117,163,13173327,13177410,4083,"zString"
"24831",45,3,107,164,13179024,13183477,4453,"zString"
"24932",45,3,116,165,13185081,13189094,4013,"zString"
"25032",45,3,103,166,13191126,13198144,7018,"zString"
"25137",45,3,118,167,13200300,13204344,4044,"zString"
"25233",45,3,91,168,13205845,13210411,4566,"zString"
"25429",45,3,119,169,13214455,13220811,6356,"zString"
"25532",45,2,162,170,13222267,13226978,4711,"zString"
"25736",45,3,111,171,13231399,13236695,5296,"zString"
"25833",45,3,105,172,13238237,13242212,3975,"zString"
"25928",45,2,179,173,13244183,13249579,5396,"zString"
"26036",45,2,165,174,13251398,13255479,4081,"zString"
"26139",45,2,159,175,13257511,13263096,5585,"zString"
"26333",45,3,98,176,13266974,13270814,3840,"zString"
"26530",45,3,99,177,13274528,13280180,5652,"zString"
"26731",45,3,94,178,13284071,13287397,3326,"zString"
"26926",45,3,120,179,13291511,13296714,5203,"zString"
"27037",45,3,109,180,13298324,13301581,3257,"zString"
"10151",46,1,9,1,1085217,1093687,8470,"zString"
"12145",46,1,25,2,1098988,1104371,5383,"zString"
"1374",46,1,17,3,1106566,1119021,12455,"zString"
"1444",46,1,20,4,1122481,1130455,7974,"zString"
"15105",46,1,5,5,1133022,1137088,4066,"zString"
"17142",46,1,15,6,1145603,1163006,17403,"zString"
"18132",46,1,4,7,1165189,1172956,7767,"zString"
"20109",46,1,29,8,1180128,1186174,6046,"zString"
"21146",46,1,16,9,1188334,1199241,10907,"zString"
"22147",46,1,18,10,1202045,1210641,8596,"zString"
"23148",46,1,28,11,1214564,1220875,6311,"zString"
"24139",46,1,23,12,1227025,1232725,5700,"zString"
"25138",46,1,3,13,1236820,1242942,6122,"zString"
"2750",46,1,30,14,1247999,1255726,7727,"zString"
"2827",46,1,14,15,1259828,1263826,3998,"zString"
"2936",46,1,6,16,1265989,1274526,8537,"zString"
"3135",46,1,21,17,1279909,1288760,8851,"zString"
"3234",46,1,26,18,1291220,1298161,6941,"zString"
"3334",46,1,7,19,1300122,1305594,5472,"zString"
"3535",46,1,11,20,1310879,1318078,7199,"zString"
"3739",46,1,13,21,1325270,1333812,8542,"zString"
"3827",46,1,12,22,1336093,1339562,3469,"zString"
"4031",46,1,10,23,1344276,1347446,3170,"zString"
"4232",46,1,19,24,1357498,1364947,7449,"zString"
"4335",46,1,2,25,1367216,1373012,5796,"zString"
"4536",46,1,27,26,1378650,1387797,9147,"zString"
"4628",46,1,22,27,1391744,1397797,6053,"zString"
"4734",46,1,8,28,1400818,1407930,7112,"zString"
"4935",46,1,1,29,1412524,1416465,3941,"zString"
"5127",46,1,24,30,1421905,1434749,12844,"zString"
"5238",46,2,31,31,1437960,1445632,7672,"zString"
"5435",46,2,32,32,1450530,1453800,3270,"zString"
"5634",46,2,33,33,1457582,1463283,5701,"zString"
"5834",46,2,42,34,1469054,1475650,6596,"zString"
"6036",46,2,35,35,1479976,1486933,6957,"zString"
"6227",46,3,88,36,1491189,1496851,5662,"zString"
"6336",46,2,46,37,1499299,1505318,6019,"zString"
"6432",46,3,85,38,1507257,1515301,8044,"zString"
"6532",46,2,37,39,1517828,1522002,4174,"zString"
"6732",46,3,66,40,1528518,1533852,5334,"zString"
"6935",46,2,57,41,1538891,1547219,8328,"zString"
"7034",46,3,86,42,1635588,1646190,10602,"zString"
"7135",46,2,44,43,1650070,1654573,4503,"zString"
"7232",46,2,43,44,1659397,1664340,4943,"zString"
"7333",46,3,69,45,1668855,1673107,4252,"zString"
"7536",46,3,67,46,1678335,1683907,5572,"zString"
"7731",46,3,87,47,1689532,1700158,10626,"zString"
"7831",46,2,51,48,1705840,1713091,7251,"zString"
"7937",46,3,82,49,1719421,1727292,7871,"zString"
"8031",46,3,81,50,1729224,1734059,4835,"zString"
"8130",46,2,49,51,1738025,1745009,6984,"zString"
"8231",46,3,78,52,1746688,1752676,5988,"zString"
"8336",46,3,73,53,1757299,1763643,6344,"zString"
"8432",46,2,47,54,1766790,1774794,8004,"zString"
"8531",46,3,64,55,1778421,1787444,9023,"zString"
"8734",46,2,45,56,1791394,1796444,5050,"zString"
"8832",46,3,68,57,1798538,1802578,4040,"zString"
"9035",46,2,54,58,1813773,1823479,9706,"zString"
"9138",46,2,36,59,1826182,1831446,5264,"zString"
"9332",46,2,56,60,1836659,1840712,4053,"zString"
"9437",46,3,83,61,1843474,1851547,8073,"zString"
"9537",46,3,62,62,1856244,1863313,7069,"zString"
"9731",46,2,41,63,1868643,1875464,6821,"zString"
"9933",46,3,84,64,1884349,1889748,5399,"zString"
"10031",46,2,50,65,1892390,1902614,10224,"zString"
"10152",46,3,79,66,1905303,1912248,6945,"zString"
"10239",46,3,65,67,1914670,1922332,7662,"zString"
"10432",46,2,39,68,1930388,1939616,9228,"zString"
"10635",46,3,63,69,1948740,1962533,13793,"zString"
"10835",46,2,55,70,1967244,1971300,4056,"zString"
"10929",46,3,61,71,1973195,1978784,5589,"zString"
"11135",46,3,89,72,1983541,1987834,4293,"zString"
"11228",46,2,58,73,1990546,1994201,3655,"zString"
"11334",46,3,74,74,1996456,2004235,7779,"zString"
"11431",46,2,48,75,2007090,2012185,5095,"zString"
"11525",46,2,60,76,2014194,2021152,6958,"zString"
"11633",46,3,77,77,2023106,2029269,6163,"zString"
"11731",46,3,70,78,2032837,2041319,8482,"zString"
"11929",46,3,90,79,2047024,2051036,4012,"zString"
"12039",46,3,76,80,2055245,2059987,4742,"zString"
"12146",46,2,34,81,2062774,2068503,5729,"zString"
"12332",46,2,38,82,2074449,2083820,9371,"zString"
"12531",46,2,53,83,2088831,2092821,3990,"zString"
"12634",46,2,52,84,2100386,2104171,3785,"zString"
"12734",46,2,40,85,2107119,2112589,5470,"zString"
"12926",46,3,72,86,2119630,2124538,4908,"zString"
"13127",46,3,71,87,2128479,2137823,9344,"zString"
"13335",46,3,75,88,2142380,2147473,5093,"zString"
"13431",46,2,59,89,2151977,2158607,6630,"zString"
"13530",46,3,80,90,2161065,2165257,4192,"zString"
"14537",46,1,114,91,2406361,2414416,8055,"reading"
"14612",46,1,107,92,2416621,2421299,4678,"reading"
"14736",46,1,105,93,2427358,2432999,5641,"reading"
"14820",46,1,108,94,2437547,2442650,5103,"reading"
"14936",46,1,116,95,2444478,2448467,3989,"reading"
"15017",46,1,92,96,2451003,2458833,7830,"reading"
"15234",46,1,115,97,2466585,2471467,4882,"reading"
"15328",46,1,102,98,2473830,2480918,7088,"reading"
"15534",46,1,111,99,2490476,2494734,4258,"reading"
"15633",46,1,98,100,2497334,2503335,6001,"reading"
"15827",46,1,120,101,2508366,2514752,6386,"reading"
"15934",46,1,101,102,2518436,2522969,4533,"reading"
"16144",46,1,97,103,2527484,2533019,5535,"reading"
"16330",46,1,119,104,2540165,2549036,8871,"reading"
"16437",46,1,106,105,2558025,2565370,7345,"reading"
"16531",46,1,100,106,2572046,2579887,7841,"reading"
"16733",46,1,96,107,2586174,2589538,3364,"reading"
"16933",46,1,110,108,2596588,2600039,3451,"reading"
"17031",46,1,91,109,2601855,2606338,4483,"reading"
"17235",46,1,93,110,2612465,2618306,5841,"reading"
"17433",46,1,103,111,2623295,2627490,4195,"reading"
"17531",46,1,99,112,2629970,2634540,4570,"reading"
"17732",46,1,95,113,2641731,2654473,12742,"reading"
"17935",46,1,112,114,2660620,2682491,21871,"reading"
"18035",46,1,117,115,2685961,2690308,4347,"reading"
"18133",46,1,104,116,2692494,2706142,13648,"reading"
"18237",46,1,113,117,2708755,2716743,7988,"reading"
"18327",46,1,118,118,2719719,2725560,5841,"reading"
"18432",46,1,94,119,2728714,2733893,5179,"reading"
"18630",46,1,109,120,2740667,2747910,7243,"reading"
"18739",46,2,121,121,2749848,2755594,5746,"reading"
"18940",46,2,122,122,2760751,2765928,5177,"reading"
"19146",46,2,123,123,2770701,2773894,3193,"reading"
"19338",46,2,142,124,2780708,2785695,4987,"reading"
"19429",46,2,133,125,2789353,2794412,5059,"reading"
"19535",46,3,171,126,2796922,2804829,7907,"reading"
"19630",46,3,163,127,2807829,2820396,12567,"reading"
"19736",46,3,180,128,2823486,2834696,11210,"reading"
"19831",46,2,137,129,2836517,2845513,8996,"reading"
"19930",46,3,151,130,2852878,2862581,9703,"reading"
"20138",46,2,138,131,2872234,2878731,6497,"reading"
"20231",46,2,147,132,3021768,3026820,5052,"reading"
"20328",46,2,127,133,3029353,3035003,5650,"reading"
"20530",46,3,164,134,3041391,3048471,7080,"reading"
"20636",46,3,172,135,3051206,3057204,5998,"reading"
"20736",46,2,125,136,3059731,3064787,5056,"reading"
"20936",46,2,129,137,3070151,3076254,6103,"reading"
"21147",46,3,174,138,3082191,3087138,4947,"reading"
"21231",46,3,169,139,3089530,3096539,7009,"reading"
"21332",46,3,170,140,3098991,3105706,6715,"reading"
"21431",46,3,175,141,3108361,3113773,5412,"reading"
"21532",46,3,156,142,3115706,3130723,15017,"reading"
"21734",46,3,162,143,3139185,3160524,21339,"reading"
"21935",46,3,176,144,3167329,3175474,8145,"reading"
"22031",46,3,159,145,3177496,3188408,10912,"reading"
"22236",46,2,145,146,3194970,3200075,5105,"reading"
"22336",46,2,140,147,3202921,3213726,10805,"reading"
"22434",46,3,173,148,3216056,3226426,10370,"reading"
"22532",46,2,148,149,3229607,3238577,8970,"reading"
"22628",46,2,136,150,3240269,3245410,5141,"reading"
"22732",46,3,161,151,3247252,3259594,12342,"reading"
"22934",46,2,131,152,3275596,3281578,5982,"reading"
"23149",46,2,141,153,3286709,3303312,16603,"reading"
"23231",46,2,124,154,3305509,3317413,11904,"reading"
"23436",46,3,177,155,3322983,3329196,6213,"reading"
"23530",46,2,126,156,3332795,3337897,5102,"reading"
"23730",46,2,128,157,3345896,3351097,5201,"reading"
"23930",46,3,154,158,3357385,3363615,6230,"reading"
"24140",46,2,143,159,3367905,3378532,10627,"reading"
"24232",46,3,166,160,3381072,3388798,7726,"reading"
"24335",46,3,157,161,3390769,3397432,6663,"reading"
"24535",46,2,132,162,3402889,3409500,6611,"reading"
"24731",46,3,165,163,3415194,3420866,5672,"reading"
"24832",46,2,146,164,3422853,3429666,6813,"reading"
"24933",46,3,179,165,3431473,3442751,11278,"reading"
"25033",46,2,134,166,3445469,3456501,11032,"reading"
"25139",46,2,135,167,3459265,3473568,14303,"reading"
"25234",46,3,168,168,3476499,3482968,6469,"reading"
"25331",46,2,149,169,3484788,3491269,6481,"reading"
"25430",46,3,167,170,3492985,3499319,6334,"reading"
"25533",46,3,153,171,3501416,3506469,5053,"reading"
"25737",46,3,152,172,3512685,3520620,7935,"reading"
"25929",46,3,178,173,3527755,3532036,4281,"reading"
"26037",46,3,160,174,3533987,3543121,9134,"reading"
"26235",46,3,155,175,3555145,3563889,8744,"reading"
"26428",46,2,130,176,3570004,3575022,5018,"reading"
"26631",46,3,158,177,3579669,3583756,4087,"reading"
"26836",46,2,150,178,3587982,3592322,4340,"reading"
"26927",46,2,144,179,3595175,3602239,7064,"reading"
"27038",46,2,139,180,3604095,3609289,5194,"reading"
"10153",47,2,1,1,4582466,4588925,6459,"reading"
"12147",47,2,2,2,4594118,4597492,3374,"reading"
"1445",47,2,3,3,4613490,4615892,2402,"reading"
"16145",47,2,14,4,4621165,4624142,2977,"reading"
"17143",47,3,46,5,4626282,4632726,6444,"reading"
"18134",47,3,39,6,4636676,4640026,3350,"reading"
"20139",47,2,16,7,4664097,4666977,2880,"reading"
"21148",47,2,29,8,4669198,4672744,3546,"reading"
"22148",47,2,12,9,4676600,4679678,3078,"reading"
"24141",47,2,4,10,4688049,4692544,4495,"reading"
"26140",47,3,60,11,4699216,4703745,4529,"reading"
"2753",47,3,47,12,4707874,4712179,4305,"reading"
"2828",47,3,50,13,4716782,4719312,2530,"reading"
"2937",47,2,23,14,4724004,4726929,2925,"reading"
"3035",47,3,37,15,4733489,4736079,2590,"reading"
"3235",47,2,27,16,4742396,4745646,3250,"reading"
"3335",47,3,48,17,4749127,4752897,3770,"reading"
"3430",47,3,56,18,4757420,4759980,2560,"reading"
"3536",47,3,58,19,4764662,4768497,3835,"reading"
"3628",47,3,49,20,4774812,4777781,2969,"reading"
"3740",47,2,18,21,4781605,4784565,2960,"reading"
"3828",47,3,57,22,4788218,4791381,3163,"reading"
"3935",47,2,13,23,4797021,4799649,2628,"reading"
"4032",47,2,28,24,4855479,4858650,3171,"reading"
"4135",47,2,21,25,4862904,4866617,3713,"reading"
"4233",47,2,17,26,4892471,4896621,4150,"reading"
"4336",47,2,19,27,4899347,4902788,3441,"reading"
"4433",47,3,54,28,4906432,4909355,2923,"reading"
"4537",47,2,9,29,4915333,4918889,3556,"reading"
"4735",47,3,52,30,4925715,4928622,2907,"reading"
"4827",47,2,20,31,4931959,4934323,2364,"reading"
"4936",47,2,10,32,4942376,4946106,3730,"reading"
"5128",47,3,35,33,4951548,4954640,3092,"reading"
"5321",47,2,5,34,4959876,4962507,2631,"reading"
"5518",47,3,31,35,4967407,4970141,2734,"reading"
"5721",47,3,55,36,4977894,4981624,3730,"reading"
"5835",47,3,44,37,4984820,4987324,2504,"reading"
"5932",47,2,8,38,4989443,4992075,2632,"reading"
"6132",47,3,38,39,5000311,5004508,4197,"reading"
"6433",47,3,32,41,5047035,5050093,3058,"reading"
"6634",47,2,30,42,5056552,5060143,3591,"reading"
"6733",47,3,45,43,5265665,5270834,5169,"reading"
"6835",47,3,51,44,5272446,5276051,3605,"reading"
"6936",47,2,22,45,5278060,5281150,3090,"reading"
"7035",47,2,6,46,5282898,5285701,2803,"reading"
"7233",47,2,7,47,5290914,5293818,2904,"reading"
"7433",47,2,25,48,5298672,5301568,2896,"reading"
"7537",47,2,11,49,5303659,5307102,3443,"reading"
"7732",47,3,40,50,5311865,5314335,2470,"reading"
"7938",47,3,34,51,5319293,5321702,2409,"reading"
"8131",47,3,33,52,5326901,5330619,3718,"reading"
"8337",47,3,43,53,5335149,5338670,3521,"reading"
"8433",47,3,42,54,5340272,5343352,3080,"reading"
"8630",47,2,26,55,5347624,5350169,2545,"reading"
"8735",47,3,53,56,5352029,5355187,3158,"reading"
"8833",47,3,36,57,5356909,5359837,2928,"reading"
"9036",47,3,59,58,5365919,5368454,2535,"reading"
"9139",47,3,41,59,5369975,5372971,2996,"reading"
"9333",47,2,15,60,5377935,5381071,3136,"reading"
"9438",47,2,24,61,5382968,5385604,2636,"reading"
"9538",47,1,64,62,5387222,5389621,2399,"reading"
"9732",47,1,75,63,5394333,5396855,2522,"reading"
"9834",47,1,76,64,5398542,5400355,1813,"reading"
"9934",47,1,69,65,5402423,5405088,2665,"reading"
"10154",47,1,89,66,5409626,5412005,2379,"reading"
"10240",47,1,88,67,5413625,5417139,3514,"reading"
"10331",47,1,74,68,5418896,5420972,2076,"reading"
"10433",47,1,66,69,5422819,5424922,2103,"reading"
"10636",47,1,70,70,5430003,5433173,3170,"reading"
"10836",47,1,68,71,5437128,5439890,2762,"reading"
"11031",47,1,90,72,5444750,5447423,2673,"reading"
"11136",47,1,72,73,5449744,5451823,2079,"reading"
"11335",47,1,65,74,5456453,5460807,4354,"reading"
"11526",47,1,67,75,5469849,5471857,2008,"reading"
"11732",47,1,79,76,5476280,5479058,2778,"reading"
"11830",47,1,77,77,5480794,5482874,2080,"reading"
"11930",47,1,83,78,5484736,5486991,2255,"reading"
"12040",47,1,63,79,5488911,5492208,3297,"reading"
"12229",47,1,82,80,5498757,5501492,2735,"reading"
"12333",47,1,84,81,5503240,5505759,2519,"reading"
"12432",47,1,71,82,5511872,5514509,2637,"reading"
"12635",47,1,62,83,5519398,5522326,2928,"reading"
"12834",47,1,86,84,5526569,5529459,2890,"reading"
"12927",47,1,78,85,5531954,5534610,2656,"reading"
"13037",47,1,85,86,5536691,5539643,2952,"reading"
"13128",47,1,80,87,5542288,5545227,2939,"reading"
"13237",47,1,87,88,5547014,5549427,2413,"reading"
"13336",47,1,61,89,5551394,5555527,4133,"reading"
"13531",47,1,73,90,5560732,5563244,2512,"reading"
"13611",47,1,81,91,5566728,5569711,2983,"reading"
"14613",47,2,91,92,5925595,5929679,4084,"zString"
"14821",47,2,92,93,5938934,5943660,4726,"zString"
"15018",47,2,93,94,5949681,5952760,3079,"zString"
"15235",47,3,147,95,5959109,5963110,4001,"zString"
"15329",47,2,96,96,5969057,5972578,3521,"zString"
"15535",47,2,108,97,6018838,6021967,3129,"zString"
"15634",47,2,97,98,6091516,6094167,2651,"zString"
"15828",47,2,118,99,6098115,6101418,3303,"zString"
"15935",47,3,122,100,6105549,6110818,5269,"zString"
"16146",47,3,148,101,6117294,6122035,4741,"zString"
"16236",47,2,111,102,6124724,6128535,3811,"zString"
"16331",47,2,95,103,6132648,6140202,7554,"zString"
"16532",47,2,109,104,6144283,6147203,2920,"zString"
"16633",47,2,116,105,6149778,6153886,4108,"zString"
"16734",47,3,139,106,6157081,6162470,5389,"zString"
"16832",47,3,137,107,6165979,6170653,4674,"zString"
"16934",47,2,99,108,6177320,6184437,7117,"zString"
"17144",47,3,143,109,6189782,6199421,9639,"zString"
"17236",47,3,124,110,6202586,6209138,6552,"zString"
"17434",47,2,117,111,6214794,6220671,5877,"zString"
"17532",47,2,112,112,6223418,6227621,4203,"zString"
"17632",47,2,114,113,6230714,6235805,5091,"zString"
"17733",47,3,141,114,6239314,6243706,4392,"zString"
"17829",47,3,123,115,6246441,6252006,5565,"zString"
"18036",47,3,150,116,6257082,6261173,4091,"zString"
"18135",47,3,142,117,6263721,6268856,5135,"zString"
"18238",47,3,121,118,6274248,6279407,5159,"zString"
"18433",47,2,94,119,6285542,6289090,3548,"zString"
"18631",47,3,125,120,6293509,6298291,4782,"zString"
"18814",47,3,146,121,6303381,6308591,5210,"zString"
"18941",47,3,128,122,6311354,6317692,6338,"zString"
"19147",47,2,104,123,6323866,6328575,4709,"zString"
"19225",47,2,115,124,6345871,6349559,3688,"zString"
"19339",47,3,138,125,6352933,6356693,3760,"zString"
"19430",47,2,110,126,6359987,6362926,2939,"zString"
"19536",47,2,106,127,6365599,6370010,4411,"zString"
"19631",47,2,107,128,6373023,6376377,3354,"zString"
"19737",47,3,129,129,6379516,6383677,4161,"zString"
"19931",47,3,145,130,6388338,6391244,2906,"zString"
"20037",47,2,105,131,6393721,6398494,4773,"zString"
"20140",47,2,100,132,6401670,6406978,5308,"zString"
"20329",47,3,135,133,6601414,6605568,4154,"zString"
"20435",47,3,140,134,6607624,6611319,3695,"zString"
"20531",47,2,98,135,6615333,6618868,3535,"zString"
"20737",47,2,101,136,6624086,6628052,3966,"zString"
"20937",47,2,119,137,6633380,6638670,5290,"zString"
"21032",47,3,126,138,6642293,6646203,3910,"zString"
"21232",47,3,136,139,6651110,6655387,4277,"zString"
"21333",47,3,149,140,6659757,6664820,5063,"zString"
"21432",47,3,127,141,6670843,6674904,4061,"zString"
"21631",47,3,132,142,6702754,6706005,3251,"zString"
"21832",47,2,113,143,6712856,6715339,2483,"zString"
"21936",47,2,103,144,6718013,6721505,3492,"zString"
"22032",47,3,130,145,6725645,6730405,4760,"zString"
"22237",47,3,134,146,6734537,6737640,3103,"zString"
"22337",47,2,120,147,6740943,6745473,4530,"zString"
"22435",47,3,133,148,6747562,6752173,4611,"zString"
"22533",47,3,144,149,6760727,6765306,4579,"zString"
"22629",47,3,131,150,6767071,6770723,3652,"zString"
"22835",47,2,102,151,6774471,6777574,3103,"zString"
"23031",47,1,163,152,6781661,6784424,2763,"zString"
"23150",47,1,151,153,6786317,6789858,3541,"zString"
"23437",47,1,158,155,6814581,6818092,3511,"zString"
"23632",47,1,155,156,6822191,6825725,3534,"zString"
"23834",47,1,160,157,6829921,6833226,3305,"zString"
"24032",47,1,173,158,6837159,6840476,3317,"zString"
"24142",47,1,169,159,6842621,6845543,2922,"zString"
"24233",47,1,171,160,6847413,6852043,4630,"zString"
"24336",47,1,154,161,6854227,6857993,3766,"zString"
"24536",47,1,152,162,6861724,6866694,4970,"zString"
"24732",47,1,164,163,6870976,6875744,4768,"zString"
"24833",47,1,162,164,6877675,6881010,3335,"zString"
"25034",47,1,159,165,6884608,6888028,3420,"zString"
"25235",47,1,165,166,6891892,6895228,3336,"zString"
"25332",47,1,172,167,6897775,6903912,6137,"zString"
"25431",47,1,178,168,6906081,6909928,3847,"zString"
"25534",47,1,168,169,6911713,6916095,4382,"zString"
"25631",47,1,179,170,6917677,6922562,4885,"zString"
"25738",47,1,166,171,6924386,6927896,3510,"zString"
"25834",47,1,175,172,6929635,6934296,4661,"zString"
"25930",47,1,161,173,6936063,6940046,3983,"zString"
"26141",47,1,174,174,6943974,6947630,3656,"zString"
"26236",47,1,176,175,6949318,6953113,3795,"zString"
"26334",47,1,157,176,6954748,6958613,3865,"zString"
"26531",47,1,170,177,6962906,6966830,3924,"zString"
"26632",47,1,153,178,6969040,6973864,4824,"zString"
"26837",47,1,177,179,6977683,6985614,7931,"zString"
"26928",47,1,156,180,6987356,6994131,6775,"zString"
"27113",47,1,180,181,6998461,7002365,3904,"zString"
"27211",47,1,167,182,7004162,7008332,4170,"zString"
"10155",48,2,61,1,7677490,7682388,4898,"zString"
"12148",48,2,62,2,7688100,7692738,4638,"zString"
"1446",48,2,63,3,7696795,7702172,5377,"zString"
"16147",48,2,78,4,7706628,7710872,4244,"zString"
"17145",48,3,29,5,7712878,7717655,4777,"zString"
"18136",48,2,73,6,7719268,7722722,3454,"zString"
"19148",48,3,28,7,7724656,7728756,4100,"zString"
"20141",48,3,4,8,7730582,7734506,3924,"zString"
"22149",48,2,83,9,7739159,7742840,3681,"zString"
"23151",48,3,21,10,7744530,7749874,5344,"zString"
"24143",48,3,19,11,7752405,7755774,3369,"zString"
"25140",48,2,65,12,7757521,7760941,3420,"zString"
"2754",48,2,64,13,7765378,7769291,3913,"zString"
"2938",48,2,66,14,7773978,7776991,3013,"zString"
"3136",48,3,5,15,7781899,7785124,3225,"zString"
"3336",48,3,10,16,7789298,7792725,3427,"zString"
"3537",48,3,25,17,7796245,7799525,3280,"zString"
"3629",48,3,3,18,7801076,7804775,3699,"zString"
"3829",48,3,18,19,7809258,7812492,3234,"zString"
"3936",48,3,17,20,7814339,7817526,3187,"zString"
"4033",48,3,26,21,7819328,7822810,3482,"zString"
"4136",48,2,75,22,7825583,7829276,3693,"zString"
"4234",48,2,89,23,7831236,7835310,4074,"zString"
"4337",48,3,1,24,7837105,7840093,2988,"zString"
"4538",48,2,77,25,7844432,7846810,2378,"zString"
"4629",48,2,69,26,7848384,7851827,3443,"zString"
"4828",48,2,81,27,7855794,7858361,2567,"zString"
"4937",48,3,16,28,7859842,7863910,4068,"zString"
"5031",48,3,8,29,7865548,7869761,4213,"zString"
"5239",48,2,82,30,7874003,7878928,4925,"zString"
"5322",48,2,68,31,7888242,7894878,6636,"zString"
"5519",48,3,30,32,7900741,7906946,6205,"zString"
"5635",48,2,70,33,7908612,7914129,5517,"zString"
"5836",48,2,74,34,7918417,7924396,5979,"zString"
"5933",48,2,85,35,7926243,7929596,3353,"zString"
"6037",48,3,13,36,7931115,7933546,2431,"zString"
"6133",48,2,67,37,7935456,7937530,2074,"zString"
"6337",48,3,2,38,7941577,7944480,2903,"zString"
"6533",48,2,79,39,7948440,7951764,3324,"zString"
"6635",48,3,15,40,7955235,7960531,5296,"zString"
"6734",48,3,24,41,7962039,7966281,4242,"zString"
"6836",48,3,6,42,8121826,8124838,3012,"zString"
"7036",48,2,72,43,8129033,8132121,3088,"zString"
"7234",48,2,84,44,8136181,8140888,4707,"zString"
"7334",48,2,90,45,8142558,8145572,3014,"zString"
"7434",48,3,9,46,8147406,8150205,2799,"zString"
"7634",48,2,71,47,8153959,8157472,3513,"zString"
"7832",48,2,87,48,8162049,8165106,3057,"zString"
"7939",48,3,22,49,8166510,8169839,3329,"zString"
"8032",48,3,12,50,8171485,8174223,2738,"zString"
"8232",48,2,80,51,8178461,8182290,3829,"zString"
"8338",48,2,76,52,8183710,8186990,3280,"zString"
"8434",48,2,86,53,8188766,8192490,3724,"zString"
"8532",48,2,88,54,8193920,8197140,3220,"zString"
"8631",48,3,27,55,8198402,8201940,3538,"zString"
"8736",48,3,7,56,8203653,8206607,2954,"zString"
"8936",48,3,14,57,8210942,8213924,2982,"zString"
"9037",48,3,23,58,8216054,8219524,3470,"zString"
"9140",48,3,20,59,8222053,8225574,3521,"zString"
"9230",48,3,11,60,8227686,8231375,3689,"zString"
"9439",48,1,38,61,8235481,8239541,4060,"zString"
"9634",48,1,58,62,8243323,8247392,4069,"zString"
"9733",48,1,53,63,8249247,8252675,3428,"zString"
"9835",48,1,40,64,8254318,8258009,3691,"zString"
"10032",48,1,51,65,8261501,8265242,3741,"zString"
"10156",48,1,39,66,8266762,8270559,3797,"zString"
"10332",48,1,54,67,8274028,8278309,4281,"zString"
"10434",48,1,45,68,8279834,8282910,3076,"zString"
"10533",48,1,35,69,8284414,8287877,3463,"zString"
"10730",48,1,31,70,8292052,8297060,5008,"zString"
"10930",48,1,41,71,8300744,8304277,3533,"zString"
"11137",48,1,56,72,8308104,8312144,4040,"zString"
"11229",48,1,49,73,8313801,8316361,2560,"zString"
"11336",48,1,59,74,8317763,8320844,3081,"zString"
"11432",48,1,42,75,8322420,8326195,3775,"zString"
"11634",48,1,36,76,8329874,8333378,3504,"zString"
"11831",48,1,52,77,8337269,8341045,3776,"zString"
"11931",48,1,55,78,8342683,8345712,3029,"zString"
"12041",48,1,37,79,8347433,8350779,3346,"zString"
"12230",48,1,57,80,8354802,8358046,3244,"zString"
"12334",48,1,46,81,8359332,8362662,3330,"zString"
"12433",48,1,43,82,8364426,8367746,3320,"zString"
"12532",48,1,32,83,8369430,8372829,3399,"zString"
"12735",48,1,50,84,8376406,8380047,3641,"zString"
"12835",48,1,60,85,8381531,8384930,3399,"zString"
"12928",48,1,48,86,8386337,8390913,4576,"zString"
"13038",48,1,47,87,8392861,8397547,4686,"zString"
"13129",48,1,34,88,8399101,8403514,4413,"zString"
"13337",48,1,44,89,8407412,8410664,3252,"zString"
"13432",48,1,33,90,8411923,8415948,4025,"zString"
"14538",48,2,151,91,8673543,8676990,3447,"reading"
"14737",48,2,152,92,8682666,8685990,3324,"reading"
"14937",48,2,153,93,8691529,8694157,2628,"reading"
"15138",48,3,104,94,8699356,8701774,2418,"reading"
"15236",48,3,114,95,8704456,8707624,3168,"reading"
"15330",48,2,154,96,8709169,8711808,2639,"reading"
"15536",48,3,102,97,8716615,8718874,2259,"reading"
"15734",48,3,120,98,8723515,8726191,2676,"reading"
"15829",48,2,178,99,8727791,8730625,2834,"reading"
"15936",48,2,180,100,8733151,8738042,4891,"reading"
"16029",48,2,161,101,8739586,8742226,2640,"reading"
"16237",48,3,100,102,8747896,8751126,3230,"reading"
"16438",48,3,112,103,8755728,8758476,2748,"reading"
"16533",48,2,169,104,8760188,8763326,3138,"reading"
"16634",48,3,96,105,8764788,8766893,2105,"reading"
"16833",48,3,99,106,8771940,8774293,2353,"reading"
"17032",48,2,158,107,8778928,8781527,2599,"reading"
"17237",48,2,157,108,8785834,8790077,4243,"reading"
"17435",48,3,119,109,8795992,8799777,3785,"reading"
"17533",48,3,105,110,8801378,8803644,2266,"reading"
"17633",48,2,170,111,8805274,8807494,2220,"reading"
"17734",48,2,162,112,8808936,8810811,1875,"reading"
"17936",48,2,165,113,8815912,8818411,2499,"reading"
"18037",48,3,118,114,8820045,8822395,2350,"reading"
"18137",48,2,168,115,8823830,8826345,2515,"reading"
"18239",48,2,177,116,8827938,8830395,2457,"reading"
"18328",48,3,115,117,8831906,8834279,2373,"reading"
"18434",48,2,155,118,8835682,8839445,3763,"reading"
"18632",48,3,110,119,8844731,8847562,2831,"reading"
"18740",48,3,94,120,8849487,8852762,3275,"reading"
"18942",48,2,179,121,8857817,8859979,2162,"reading"
"19022",48,2,164,122,8861619,8864413,2794,"reading"
"19149",48,3,107,123,8866638,8868813,2175,"reading"
"19226",48,3,116,124,8870325,8872563,2238,"reading"
"19340",48,2,171,125,8873986,8876913,2927,"reading"
"19431",48,3,109,126,8878415,8881097,2682,"reading"
"19537",48,2,172,127,8882299,8884897,2598,"reading"
"19632",48,2,173,128,8886398,8889247,2849,"reading"
"19738",48,2,163,129,8890383,8893130,2747,"reading"
"19832",48,3,106,130,8894632,8897731,3099,"reading"
"19932",48,2,176,131,8899053,8901448,2395,"reading"
"20038",48,2,160,132,9300327,9303447,3120,"reading"
"20232",48,2,175,133,9308711,9311864,3153,"reading"
"20330",48,2,174,134,9313493,9316531,3038,"reading"
"20436",48,2,156,135,9318314,9321031,2717,"reading"
"20637",48,3,95,136,9325875,9328315,2440,"reading"
"20832",48,3,117,137,9333527,9335582,2055,"reading"
"20938",48,3,92,138,9337151,9339649,2498,"reading"
"21149",48,2,166,139,9344382,9347966,3584,"reading"
"21233",48,3,103,140,9349444,9351716,2272,"reading"
"21334",48,3,101,141,9353320,9355632,2312,"reading"
"21533",48,2,167,142,9361502,9364116,2614,"reading"
"21632",48,3,113,143,9365912,9368166,2254,"reading"
"21735",48,3,97,144,9369691,9372216,2525,"reading"
"21937",48,3,93,145,9376936,9379117,2181,"reading"
"22150",48,3,91,146,9383800,9386017,2217,"reading"
"22338",48,3,98,147,9391213,9393451,2238,"reading"
"22534",48,3,108,148,9398790,9401334,2544,"reading"
"22630",48,2,159,149,9403058,9405134,2076,"reading"
"22836",48,3,111,150,9410060,9412684,2624,"reading"
"22935",48,1,128,151,9414313,9416285,1972,"reading"
"23152",48,1,148,152,9421507,9423703,2196,"reading"
"23232",48,1,121,153,9425772,9427768,1996,"reading"
"23438",48,1,127,154,9432233,9434119,1886,"reading"
"23633",48,1,147,155,9441094,9443752,2658,"reading"
"23731",48,1,124,156,9446181,9448636,2455,"reading"
"23931",48,1,145,157,9455521,9457619,2098,"reading"
"24033",48,1,150,158,9459528,9462019,2491,"reading"
"24144",48,1,134,159,9463917,9466720,2803,"reading"
"24234",48,1,144,160,9468683,9471370,2687,"reading"
"24337",48,1,126,161,9473342,9475453,2111,"reading"
"24537",48,1,143,162,9480990,9484637,3647,"reading"
"24633",48,1,140,163,9486154,9488487,2333,"reading"
"24733",48,1,137,164,9490184,9492370,2186,"reading"
"24834",48,1,142,165,9494024,9496371,2347,"reading"
"24934",48,1,136,166,9497844,9500004,2160,"reading"
"25035",48,1,125,167,9501661,9503904,2243,"reading"
"25236",48,1,123,168,9509668,9512138,2470,"reading"
"25432",48,1,149,169,9516741,9519555,2814,"reading"
"25535",48,1,135,170,9521701,9524021,2320,"reading"
"25632",48,1,146,171,9525752,9528572,2820,"reading"
"25739",48,1,122,172,9530925,9532988,2063,"reading"
"25931",48,1,132,173,9537196,9539289,2093,"reading"
"26142",48,1,141,174,9544028,9546806,2778,"reading"
"26237",48,1,130,175,9548790,9550907,2117,"reading"
"26429",48,1,131,176,9556946,9558989,2043,"reading"
"26633",48,1,133,177,9563621,9566089,2468,"reading"
"26732",48,1,139,178,9568768,9570790,2022,"reading"
"26838",48,1,138,179,9572408,9575007,2599,"reading"
"26929",48,1,129,180,9576789,9579324,2535,"reading"
"10157",49,1,3,1,483267,486509,3242,"reading"
"12149",49,1,9,2,492807,497227,4420,"reading"
"1447",49,1,14,3,501471,505110,3639,"reading"
"15106",49,1,28,4,507002,510144,3142,"reading"
"16148",49,1,17,5,511954,516277,4323,"reading"
"17146",49,1,1,6,517850,522060,4210,"reading"
"19150",49,1,25,7,529281,534144,4863,"reading"
"20142",49,1,15,8,539430,543662,4232,"reading"
"21150",49,1,6,9,547627,552062,4435,"reading"
"23153",49,1,12,10,559144,563312,4168,"reading"
"25141",49,1,8,11,569229,573379,4150,"reading"
"2755",49,1,5,12,578665,581729,3064,"reading"
"2939",49,1,7,13,586862,592229,5367,"reading"
"3137",49,1,30,14,598694,602547,3853,"reading"
"3236",49,1,23,15,605252,610064,4812,"reading"
"3337",49,1,18,16,612664,618280,5616,"reading"
"3431",49,1,20,17,620572,624414,3842,"reading"
"3538",49,1,11,18,627780,634282,6502,"reading"
"3741",49,1,29,19,644847,648248,3401,"reading"
"3830",49,1,19,20,649644,653132,3488,"reading"
"3937",49,1,13,21,654901,661149,6248,"reading"
"4034",49,1,16,22,667923,672849,4926,"reading"
"4137",49,1,10,23,674472,677800,3328,"reading"
"4338",49,1,24,24,682401,686583,4182,"reading"
"4434",49,1,21,25,691234,698734,7500,"reading"
"4539",49,1,4,26,700186,704234,4048,"reading"
"4736",49,1,27,27,712457,716851,4394,"reading"
"4829",49,1,2,28,718415,724267,5852,"reading"
"5032",49,1,22,29,728181,731768,3587,"reading"
"5129",49,1,26,30,733558,736452,2894,"reading"
"5240",49,2,31,31,738732,743619,4887,"reading"
"5436",49,2,32,32,747801,751185,3384,"reading"
"5636",49,2,33,33,758795,763286,4491,"reading"
"5837",49,3,81,34,772090,777186,5096,"reading"
"5934",49,2,34,35,779658,783070,3412,"reading"
"6134",49,2,38,36,787747,791970,4223,"reading"
"6338",49,2,36,37,796685,800120,3435,"reading"
"6534",49,3,83,38,805245,809354,4109,"reading"
"6636",49,2,47,39,811901,817754,5853,"reading"
"6735",49,2,35,40,820906,823721,2815,"reading"
"6937",49,2,40,41,827964,831688,3724,"reading"
"7136",49,2,49,42,1001295,1006794,5499,"reading"
"7235",49,3,74,43,1009131,1013161,4030,"reading"
"7335",49,3,63,44,1014681,1018561,3880,"reading"
"7538",49,2,59,45,1024539,1026695,2156,"reading"
"7635",49,2,45,46,1028050,1031345,3295,"reading"
"7733",49,2,50,47,1032773,1035795,3022,"reading"
"7833",49,3,67,48,1037173,1039495,2322,"reading"
"8033",49,3,89,49,1043688,1047779,4091,"reading"
"8132",49,3,73,50,1050325,1053612,3287,"reading"
"8233",49,3,77,51,1054866,1058246,3380,"reading"
"8339",49,2,53,52,1059526,1063379,3853,"reading"
"8435",49,2,52,53,1064675,1068280,3605,"reading"
"8533",49,3,85,54,1069576,1073996,4420,"reading"
"8632",49,2,46,55,1075149,1079180,4031,"reading"
"8737",49,3,90,56,1080520,1083096,2576,"reading"
"8834",49,3,75,57,1084296,1088030,3734,"reading"
"8937",49,3,61,58,1089184,1093597,4413,"reading"
"9141",49,2,60,59,1098687,1101431,2744,"reading"
"9231",49,3,65,60,1102741,1106914,4173,"reading"
"9440",49,3,86,61,1111960,1115431,3471,"reading"
"9539",49,3,70,62,1116835,1120631,3796,"reading"
"9734",49,3,88,63,1124651,1128165,3514,"reading"
"9836",49,2,54,64,1129632,1132298,2666,"reading"
"9935",49,3,68,65,1133636,1136515,2879,"reading"
"10158",49,3,87,66,1140618,1143682,3064,"reading"
"10241",49,3,84,67,1144867,1147966,3099,"reading"
"10333",49,2,39,68,1149137,1152549,3412,"reading"
"10534",49,3,69,69,1157074,1159682,2608,"reading"
"10731",49,3,78,70,1165072,1168983,3911,"reading"
"10837",49,2,43,71,1170563,1173900,3337,"reading"
"10931",49,3,76,72,1175709,1178933,3224,"reading"
"11032",49,2,51,73,1182513,1185933,3420,"reading"
"11138",49,2,44,74,1187651,1190184,2533,"reading"
"11230",49,2,41,75,1191436,1193667,2231,"reading"
"11433",49,3,66,76,1198258,1200717,2459,"reading"
"11635",49,2,42,77,1205733,1209468,3735,"reading"
"11832",49,2,37,78,1214852,1218135,3283,"reading"
"12042",49,2,58,79,1224924,1228335,3411,"reading"
"12150",49,3,62,80,1229673,1231985,2312,"reading"
"12335",49,3,80,81,1235952,1238468,2516,"reading"
"12434",49,2,57,82,1240087,1243885,3798,"reading"
"12533",49,3,72,83,1245611,1248769,3158,"reading"
"12736",49,3,71,84,1253778,1257202,3424,"reading"
"12929",49,2,48,85,1261556,1264769,3213,"reading"
"13039",49,2,56,86,1266481,1269803,3322,"reading"
"13130",49,3,79,87,1271177,1273136,1959,"reading"
"13238",49,3,82,88,1274770,1277653,2883,"reading"
"13338",49,3,64,89,1279441,1283253,3812,"reading"
"13532",49,2,55,90,1290755,1294337,3582,"reading"
"14539",49,1,99,91,1550230,1552929,2699,"zString"
"14738",49,1,113,92,1557110,1558896,1786,"zString"
"14822",49,1,115,93,1562014,1564447,2433,"zString"
"14938",49,1,105,94,1566897,1569380,2483,"zString"
"15019",49,1,119,95,1572443,1579248,6805,"zString"
"15139",49,1,97,96,1581497,1584264,2767,"zString"
"15331",49,1,95,97,1588533,1594598,6065,"zString"
"15537",49,1,118,98,1598115,1600981,2866,"zString"
"15635",49,1,100,99,1603110,1605748,2638,"zString"
"15830",49,1,93,100,1611145,1613265,2120,"zString"
"16030",49,1,110,101,1617172,1620482,3310,"zString"
"16149",49,1,106,102,1622342,1625915,3573,"zString"
"16238",49,1,94,103,1627703,1631932,4229,"zString"
"16439",49,1,104,104,1635414,1638866,3452,"zString"
"16534",49,1,108,105,1640263,1644567,4304,"zString"
"16635",49,1,102,106,1645986,1649116,3130,"zString"
"16834",49,1,109,107,1653327,1655383,2056,"zString"
"16935",49,1,103,108,1656744,1660250,3506,"zString"
"17033",49,1,116,109,1661942,1665500,3558,"zString"
"17147",49,1,91,110,1667498,1670083,2585,"zString"
"17330",49,1,92,111,1674937,1678017,3080,"zString"
"17534",49,1,107,112,1682002,1684984,2982,"zString"
"17634",49,1,114,113,1686454,1688985,2531,"zString"
"17735",49,1,117,114,1690852,1693984,3132,"zString"
"17830",49,1,101,115,1695794,1698501,2707,"zString"
"18038",49,1,120,116,1705079,1708851,3772,"zString"
"18138",49,1,111,117,1712063,1715135,3072,"zString"
"18240",49,1,96,118,1717185,1720552,3367,"zString"
"18435",49,1,98,119,1727171,1729569,2398,"zString"
"18633",49,1,112,120,1735643,1739702,4059,"zString"
"18741",49,2,121,121,1743974,1746719,2745,"zString"
"18943",49,2,122,122,1755259,1757970,2711,"zString"
"19151",49,2,123,123,1764360,1766987,2627,"zString"
"19341",49,2,146,124,1774769,1777604,2835,"zString"
"19432",49,3,165,125,1780511,1783587,3076,"zString"
"19633",49,2,134,127,1819672,1821724,2052,"zString"
"19739",49,3,162,128,1823244,1825424,2180,"zString"
"19933",49,2,148,129,1829314,1831858,2544,"zString"
"20039",49,2,125,130,1833537,1835425,1888,"zString"
"20233",49,3,155,131,1838847,1841692,2845,"zString"
"20437",49,3,176,132,1845427,1848375,2948,"zString"
"20532",49,2,127,133,2005525,2007798,2273,"zString"
"20738",49,3,163,134,2011345,2013847,2502,"zString"
"20939",49,2,129,136,2045518,2047799,2281,"zString"
"21151",49,2,128,137,2051422,2054249,2827,"zString"
"21335",49,2,133,138,2057835,2060299,2464,"zString"
"21433",49,3,158,139,2061842,2064982,3140,"zString"
"21633",49,2,138,140,2069116,2071066,1950,"zString"
"21736",49,3,180,141,2073232,2075950,2718,"zString"
"21833",49,3,173,142,2077515,2079583,2068,"zString"
"21938",49,2,136,143,2081016,2084216,3200,"zString"
"22033",49,3,179,144,2086453,2088833,2380,"zString"
"22151",49,2,149,145,2090860,2093834,2974,"zString"
"22238",49,2,124,146,2095956,2098251,2295,"zString"
"22436",49,3,177,147,2102003,2104917,2914,"zString"
"22535",49,2,139,148,2106969,2109134,2165,"zString"
"22631",49,3,153,149,2110919,2113351,2432,"zString"
"22837",49,3,171,150,2117488,2120086,2598,"zString"
"22936",49,2,132,151,2123642,2126402,2760,"zString"
"23154",49,3,156,152,2130541,2133668,3127,"zString"
"23339",49,2,137,153,2140199,2142852,2653,"zString"
"23439",49,3,172,154,2145228,2148552,3324,"zString"
"23531",49,3,151,155,2150599,2153403,2804,"zString"
"23732",49,3,169,156,2157272,2159353,2081,"zString"
"23835",49,3,174,157,2160774,2162803,2029,"zString"
"23932",49,3,166,158,2164373,2166869,2496,"zString"
"24034",49,2,126,159,2168767,2171136,2369,"zString"
"24235",49,3,164,160,2174995,2177836,2841,"zString"
"24338",49,2,131,161,2183360,2185854,2494,"zString"
"24538",49,2,141,162,2190622,2193737,3115,"zString"
"24634",49,3,157,163,2195666,2197787,2121,"zString"
"24835",49,3,154,164,2204848,2207571,2723,"zString"
"25036",49,2,135,165,2214577,2217657,3080,"zString"
"25142",49,3,167,166,2223536,2226221,2685,"zString"
"25237",49,3,160,167,2233961,2237038,3077,"zString"
"25433",49,3,168,168,2243872,2246705,2833,"zString"
"25536",49,2,142,169,2248419,2251222,2803,"zString"
"25633",49,3,170,170,2256475,2259372,2897,"zString"
"25740",49,3,159,171,2275147,2277373,2226,"zString"
"25932",49,2,147,172,2281079,2283590,2511,"zString"
"26038",49,3,161,173,2285647,2288074,2427,"zString"
"26238",49,2,150,174,2291451,2293874,2423,"zString"
"26335",49,2,145,175,2295566,2298458,2892,"zString"
"26430",49,3,178,176,2302852,2305958,3106,"zString"
"26532",49,3,152,177,2307772,2311141,3369,"zString"
"26733",49,2,130,178,2314950,2317224,2274,"zString"
"26930",49,2,143,179,2321260,2324024,2764,"zString"
"27039",49,2,144,180,2325690,2328508,2818,"zString"
"27114",49,3,175,181,2330197,2333508,3311,"zString"
"27212",49,2,140,182,2335068,2338142,3074,"zString"
"10159",50,1,70,1,3873826,3878078,4252,"zString"
"12151",50,1,78,2,3882707,3887661,4954,"zString"
"1375",50,1,82,3,3890200,3894911,4711,"zString"
"1448",50,1,65,4,3897787,3904462,6675,"zString"
"16150",50,1,90,5,3909804,3913962,4158,"zString"
"17148",50,1,69,6,3915662,3920712,5050,"zString"
"19152",50,1,61,7,3925691,3930562,4871,"zString"
"21152",50,1,75,8,3936829,3946363,9534,"zString"
"22152",50,1,74,9,3947998,3957297,9299,"zString"
"23155",50,1,85,10,3959646,3965581,5935,"zString"
"24145",50,1,86,11,3968314,3972531,4217,"zString"
"25143",50,1,64,12,3977006,3983581,6575,"zString"
"2756",50,1,72,13,3987962,3994348,6386,"zString"
"2940",50,1,77,14,4000694,4005765,5071,"zString"
"3036",50,1,73,15,4007998,4014465,6467,"zString"
"3138",50,1,63,16,4016623,4023833,7210,"zString"
"3338",50,1,68,17,4028116,4034599,6483,"zString"
"3539",50,1,71,18,4042550,4051000,8450,"zString"
"3742",50,1,81,19,4055962,4062134,6172,"zString"
"3831",50,1,80,20,4064068,4068701,4633,"zString"
"3938",50,1,62,21,4070800,4075268,4468,"zString"
"4138",50,1,76,22,4079785,4084468,4683,"zString"
"4235",50,1,87,23,4088561,4094285,5724,"zString"
"4339",50,1,66,24,4096381,4101135,4754,"zString"
"4540",50,1,83,25,4105006,4110886,5880,"zString"
"4630",50,1,89,26,4113088,4120352,7264,"zString"
"4737",50,1,84,27,4122402,4126719,4317,"zString"
"4830",50,1,67,28,4128566,4132803,4237,"zString"
"5033",50,1,79,29,4137640,4141603,3963,"zString"
"5130",50,1,88,30,4143661,4149004,5343,"zString"
"5241",50,2,1,31,4151257,4155504,4247,"zString"
"5437",50,2,2,32,4159968,4166454,6486,"zString"
"5637",50,2,3,33,4170701,4174588,3887,"zString"
"5838",50,2,18,34,4179005,4183755,4750,"zString"
"5935",50,3,41,35,4185359,4190188,4829,"zString"
"6135",50,3,60,36,4194229,4199922,5693,"zString"
"6228",50,3,36,37,4201862,4206922,5060,"zString"
"6434",50,2,17,38,4211705,4216523,4818,"zString"
"6535",50,3,58,39,4218530,4222506,3976,"zString"
"6637",50,2,6,40,4224072,4230789,6717,"zString"
"6837",50,2,30,41,4234823,4240656,5833,"zString"
"6938",50,2,24,42,4415845,4421113,5268,"zString"
"7037",50,3,34,43,4422674,4426030,3356,"zString"
"7236",50,3,38,44,4429774,4433663,3889,"zString"
"7435",50,3,35,45,4437707,4440980,3273,"zString"
"7636",50,3,53,46,4444654,4448780,4126,"zString"
"7734",50,3,42,47,4450332,4453880,3548,"zString"
"7940",50,3,37,48,4457782,4461814,4032,"zString"
"8133",50,3,39,49,4466616,4470548,3932,"zString"
"8340",50,3,48,50,4474239,4479265,5026,"zString"
"8436",50,2,23,51,4480916,4484982,4066,"zString"
"8534",50,2,16,52,4486520,4491931,5411,"zString"
"8633",50,2,28,53,4493427,4498349,4922,"zString"
"8738",50,3,51,54,4499900,4504649,4749,"zString"
"8835",50,2,14,55,4506097,4509849,3752,"zString"
"8938",50,2,5,56,4511280,4514716,3436,"zString"
"9142",50,3,59,57,4519085,4523733,4648,"zString"
"9232",50,2,20,58,4525268,4529833,4565,"zString"
"9334",50,2,15,59,4531511,4535716,4205,"zString"
"9441",50,3,45,60,4537065,4540750,3685,"zString"
"9540",50,2,9,61,4542080,4544800,2720,"zString"
"9735",50,3,57,62,4549275,4553468,4193,"zString"
"9837",50,2,27,63,4555397,4559051,3654,"zString"
"9936",50,3,43,64,4560979,4564918,3939,"zString"
"10033",50,2,13,65,4566381,4569884,3503,"zString"
"10160",50,2,11,66,4571667,4576401,4734,"zString"
"10334",50,2,10,67,4580493,4583268,2775,"zString"
"10535",50,2,19,68,4586911,4591202,4291,"zString"
"10637",50,3,40,69,4592837,4598102,5265,"zString"
"10838",50,2,7,70,4602218,4606085,3867,"zString"
"11033",50,2,25,71,4609772,4612553,2781,"zString"
"11139",50,3,49,72,4614169,4618053,3884,"zString"
"11231",50,3,46,73,4620503,4623620,3117,"zString"
"11337",50,3,33,74,4624822,4628370,3548,"zString"
"11527",50,2,8,75,4632331,4636886,4555,"zString"
"11733",50,3,52,76,4641241,4646120,4879,"zString"
"11833",50,2,26,77,4648186,4651337,3151,"zString"
"11932",50,3,31,78,4653109,4657454,4345,"zString"
"12152",50,2,22,79,4661585,4665421,3836,"zString"
"12231",50,3,50,80,4666790,4671471,4681,"zString"
"12336",50,2,21,81,4673958,4677454,3496,"zString"
"12435",50,2,12,82,4679515,4683472,3957,"zString"
"12636",50,3,55,83,4687070,4691172,4102,"zString"
"12737",50,3,32,84,4692630,4696505,3875,"zString"
"12930",50,3,47,85,4700947,4705672,4725,"zString"
"13040",50,3,54,86,4707031,4710539,3508,"zString"
"13131",50,2,29,87,4712613,4715923,3310,"zString"
"13239",50,3,56,88,4718085,4722324,4239,"zString"
"13339",50,2,4,89,4724319,4728456,4137,"zString"
"13533",50,3,44,90,4732753,4737757,5004,"zString"
"14540",50,1,180,91,4945428,4949181,3753,"reading"
"14614",50,1,178,92,4951077,4954598,3521,"reading"
"14739",50,1,165,93,4956684,4961181,4497,"reading"
"14823",50,1,167,94,4962843,4966981,4138,"reading"
"14939",50,1,153,95,4968765,4972065,3300,"reading"
"15140",50,1,168,96,4977199,4980515,3316,"reading"
"15237",50,1,151,97,4981996,4985949,3953,"reading"
"15435",50,1,158,98,4992299,4995882,3583,"reading"
"15636",50,1,156,99,5000894,5004249,3355,"reading"
"15831",50,1,179,100,5009920,5013416,3496,"reading"
"15937",50,1,164,101,5015376,5019266,3890,"reading"
"16031",50,1,163,102,5020997,5024950,3953,"reading"
"16151",50,1,154,103,5026587,5030133,3546,"reading"
"16332",50,1,166,104,5034853,5040084,5231,"reading"
"16440",50,1,173,105,5041703,5044751,3048,"reading"
"16535",50,1,152,106,5046503,5051584,5081,"reading"
"16735",50,1,171,107,5056554,5060367,3813,"reading"
"16835",50,1,177,108,5062190,5067385,5195,"reading"
"16936",50,1,176,109,5069117,5073718,4601,"reading"
"17034",50,1,162,110,5075468,5078335,2867,"reading"
"17238",50,1,172,111,5083327,5086818,3491,"reading"
"17331",50,1,157,112,5088410,5092552,4142,"reading"
"17535",50,1,174,113,5098139,5101819,3680,"reading"
"17635",50,1,161,114,5103242,5107169,3927,"reading"
"17831",50,1,170,115,5111820,5115320,3500,"reading"
"17937",50,1,160,116,5116756,5121487,4731,"reading"
"18139",50,1,155,117,5127279,5130520,3241,"reading"
"18329",50,1,159,118,5135678,5140204,4526,"reading"
"18532",50,1,169,119,5146931,5151105,4174,"reading"
"18634",50,1,175,120,5152681,5156387,3706,"reading"
"18742",50,2,91,121,5158355,5162188,3833,"reading"
"18944",50,2,92,122,5168802,5172838,4036,"reading"
"19153",50,2,93,123,5177812,5180738,2926,"reading"
"19342",50,3,124,124,5184897,5189888,4991,"reading"
"19538",50,3,150,125,5195086,5198907,3821,"reading"
"19634",50,3,139,126,5200267,5203222,2955,"reading"
"19740",50,3,144,127,5204949,5208456,3507,"reading"
"19833",50,3,146,128,5210588,5214906,4318,"reading"
"19934",50,3,134,129,5216976,5220940,3964,"reading"
"20040",50,3,131,130,5222724,5227140,4416,"reading"
"20234",50,3,128,131,5232084,5236840,4756,"reading"
"20438",50,3,135,132,5387810,5391979,4169,"reading"
"20533",50,2,120,133,5393577,5397163,3586,"reading"
"20638",50,2,104,134,5398845,5402479,3634,"reading"
"20739",50,2,113,135,5404281,5406946,2665,"reading"
"20833",50,2,100,136,5408383,5411363,2980,"reading"
"21033",50,2,107,137,5416557,5420897,4340,"reading"
"21153",50,3,145,138,5422383,5425813,3430,"reading"
"21234",50,3,142,139,5427550,5431781,4231,"reading"
"21336",50,2,97,140,5433761,5436764,3003,"reading"
"21534",50,3,125,141,5441405,5444997,3592,"reading"
"21737",50,2,110,142,5450352,5452948,2596,"reading"
"21834",50,3,149,143,5454534,5459531,4997,"reading"
"21939",50,2,118,144,5461165,5464532,3367,"reading"
"22034",50,2,95,145,5466285,5469648,3363,"reading"
"22239",50,3,132,146,5474785,5478532,3747,"reading"
"22437",50,2,119,147,5485620,5489899,4279,"reading"
"22536",50,2,98,148,5491362,5496516,5154,"reading"
"22733",50,3,140,149,5501500,5505166,3666,"reading"
"22838",50,2,111,150,5508935,5512716,3781,"reading"
"22937",50,2,114,151,5516848,5521517,4669,"reading"
"23032",50,2,109,152,5524717,5528150,3433,"reading"
"23156",50,3,141,153,5532503,5536201,3698,"reading"
"23233",50,2,94,154,5540502,5543668,3166,"reading"
"23440",50,2,116,155,5549083,5552985,3902,"reading"
"23532",50,3,127,156,5555870,5559585,3715,"reading"
"23733",50,3,133,157,5564633,5568652,4019,"reading"
"23836",50,3,130,158,5570438,5574218,3780,"reading"
"24035",50,2,102,159,5578639,5582185,3546,"reading"
"24236",50,2,112,160,5587300,5590752,3452,"reading"
"24339",50,3,122,161,5592539,5595952,3413,"reading"
"24539",50,3,138,162,5600331,5603769,3438,"reading"
"24635",50,3,137,163,5609097,5613637,4540,"reading"
"24734",50,3,123,164,5615580,5619387,3807,"reading"
"24935",50,3,126,165,5625085,5628587,3502,"reading"
"25144",50,2,101,166,5635221,5638204,2983,"reading"
"25333",50,3,148,167,5643794,5647338,3544,"reading"
"25434",50,2,96,168,5649906,5653038,3132,"reading"
"25634",50,3,147,169,5659125,5663605,4480,"reading"
"25741",50,2,106,170,5665565,5669755,4190,"reading"
"25835",50,3,136,171,5671938,5676606,4668,"reading"
"25933",50,2,103,172,5678311,5681972,3661,"reading"
"26039",50,2,115,173,5683642,5686722,3080,"reading"
"26143",50,2,108,174,5688585,5691523,2938,"reading"
"26239",50,2,99,175,5693314,5695973,2659,"reading"
"26431",50,2,117,176,5700518,5704291,3773,"reading"
"26533",50,3,121,177,5707521,5710957,3436,"reading"
"26734",50,3,129,178,5715580,5719257,3677,"reading"
"26931",50,2,105,179,5726126,5729557,3431,"reading"
"27040",50,3,143,180,5731528,5735891,4363,"reading"
"10161",51,2,61,1,7989159,7994301,5142,"reading"
"12153",51,2,62,2,8000368,8005668,5300,"reading"
"1449",51,2,63,3,8012086,8017951,5865,"reading"
"16152",51,2,80,4,8024827,8030335,5508,"reading"
"17149",51,2,66,5,8032471,8038369,5898,"reading"
"19154",51,3,17,6,8045309,8053603,8294,"reading"
"20143",51,3,9,7,8056416,8060803,4387,"reading"
"22153",51,2,79,8,8067779,8073537,5758,"reading"
"23157",51,3,4,9,8075924,8082704,6780,"reading"
"25145",51,3,29,10,8089367,8096588,7221,"reading"
"26144",51,2,82,11,8099408,8105621,6213,"reading"
"2757",51,2,77,12,8109877,8113738,3861,"reading"
"2829",51,2,69,13,8116379,8122088,5709,"reading"
"3037",51,2,75,14,8127316,8133256,5940,"reading"
"3139",51,3,16,15,8137166,8142773,5607,"reading"
"3237",51,2,90,16,8145656,8151623,5967,"reading"
"3339",51,2,88,17,8154569,8159223,4654,"reading"
"3432",51,2,89,18,8162142,8167823,5681,"reading"
"3540",51,3,22,19,8206018,8212791,6773,"reading"
"3630",51,3,30,20,8215425,8221892,6467,"reading"
"3743",51,3,23,21,8224434,8230009,5575,"reading"
"3832",51,3,18,22,8233991,8238642,4651,"reading"
"3939",51,2,67,23,8241442,8248043,6601,"reading"
"4139",51,2,64,24,8253868,8258560,4692,"reading"
"4340",51,3,3,25,8264521,8268793,4272,"reading"
"4541",51,3,7,26,8275173,8280994,5821,"reading"
"4738",51,3,11,27,8287490,8293244,5754,"reading"
"4938",51,3,25,28,8298988,8303528,4540,"reading"
"5034",51,2,68,29,8305432,8311512,6080,"reading"
"5242",51,3,21,30,8317318,8323045,5727,"reading"
"5323",51,2,78,31,8327220,8333379,6159,"reading"
"5438",51,3,28,32,8335768,8341996,6228,"reading"
"5520",51,3,19,33,8343903,8350979,7076,"reading"
"5638",51,2,65,34,8352949,8359947,6998,"reading"
"5839",51,2,87,35,8364930,8370263,5333,"reading"
"5936",51,2,86,36,8373457,8379830,6373,"reading"
"6038",51,3,26,37,8382486,8389231,6745,"reading"
"6136",51,2,81,38,8392142,8396781,4639,"reading"
"6229",51,3,10,39,8398231,8403015,4784,"reading"
"6435",51,3,27,40,8409016,8413165,4149,"reading"
"6536",51,3,6,41,8416912,8422332,5420,"reading"
"6736",51,3,15,42,8579310,8584671,5361,"reading"
"6838",51,2,71,43,8589047,8594355,5308,"reading"
"7038",51,2,85,44,8601525,8607138,5613,"reading"
"7137",51,3,8,45,8613420,8618872,5452,"reading"
"7336",51,3,14,46,8651633,8656673,5040,"reading"
"7436",51,2,84,47,8671260,8678791,7531,"reading"
"7539",51,3,24,48,8712172,8717775,5603,"reading"
"7637",51,2,83,49,8720198,8726026,5828,"reading"
"7735",51,2,73,50,8731019,8737126,6107,"reading"
"7834",51,2,72,51,8741159,8746576,5417,"reading"
"8034",51,3,5,52,8752587,8758160,5573,"reading"
"8234",51,3,1,53,8763768,8770560,6792,"reading"
"8437",51,3,13,54,8781049,8787144,6095,"reading"
"8535",51,2,74,55,8816927,8823479,6552,"reading"
"8634",51,2,70,56,8825909,8830146,4237,"reading"
"8836",51,2,76,57,8836931,8841796,4865,"reading"
"8939",51,3,12,58,8846164,8852396,6232,"reading"
"9143",51,3,2,59,8857020,8862013,4993,"reading"
"9335",51,3,20,60,8866639,8871314,4675,"reading"
"9442",51,1,55,61,8876783,8882398,5615,"reading"
"9541",51,1,41,62,8884488,8891564,7076,"reading"
"9736",51,1,51,63,8898178,8903132,4954,"reading"
"9838",51,1,49,64,8905048,8909248,4200,"reading"
"9937",51,1,36,65,8911218,8916399,5181,"reading"
"10162",51,1,44,66,8921152,8926632,5480,"reading"
"10242",51,1,35,67,8928594,8935266,6672,"reading"
"10435",51,1,46,68,8940620,8945416,4796,"reading"
"10536",51,1,47,69,8947211,8954067,6856,"reading"
"10638",51,1,45,70,8955985,8961800,5815,"reading"
"10732",51,1,58,71,8963664,8970184,6520,"reading"
"10839",51,1,31,72,8972050,8978168,6118,"reading"
"11034",51,1,32,73,8982764,8988218,5454,"reading"
"11232",51,1,53,74,8994169,9000151,5982,"reading"
"11338",51,1,37,75,9002005,9006902,4897,"reading"
"11528",51,1,52,76,9012588,9017219,4631,"reading"
"11636",51,1,38,77,9019791,9026669,6878,"reading"
"11834",51,1,48,78,9031442,9036620,5178,"reading"
"11933",51,1,39,79,9038656,9043903,5247,"reading"
"12154",51,1,34,80,9048059,9053203,5144,"reading"
"12337",51,1,33,81,9058828,9063654,4826,"reading"
"12534",51,1,59,82,9069442,9074337,4895,"reading"
"12637",51,1,54,83,9076726,9081021,4295,"reading"
"12738",51,1,43,84,9083432,9089471,6039,"reading"
"12836",51,1,56,85,9091344,9097655,6311,"reading"
"12931",51,1,40,86,9099374,9105605,6231,"reading"
"13132",51,1,42,87,9111240,9115772,4532,"reading"
"13340",51,1,50,88,9122437,9129289,6852,"reading"
"13433",51,1,60,89,9130936,9135689,4753,"reading"
"13534",51,1,57,90,9137528,9143823,6295,"reading"
"14541",51,2,151,91,9411833,9417032,5199,"zString"
"14740",51,2,152,92,9423864,9429199,5335,"zString"
"14940",51,2,153,93,9434454,9439283,4829,"zString"
"15141",51,3,101,94,9444593,9448233,3640,"zString"
"15332",51,2,161,95,9455702,9460667,4965,"zString"
"15538",51,3,109,96,9495591,9498618,3027,"zString"
"15637",51,3,92,97,9502407,9507185,4778,"zString"
"15832",51,2,156,98,9515750,9523819,8069,"zString"
"16032",51,2,155,99,9530475,9535986,5511,"zString"
"16239",51,2,158,100,9541445,9547170,5725,"zString"
"16441",51,2,164,101,9576974,9582271,5297,"zString"
"16536",51,3,120,102,9587442,9592871,5429,"zString"
"16636",51,3,112,103,9596671,9602056,5385,"zString"
"16736",51,2,159,104,9609646,9614139,4493,"zString"
"16937",51,2,172,105,9625259,9631006,5747,"zString"
"17035",51,2,157,106,9660765,9665608,4843,"zString"
"17239",51,2,178,107,9671282,9675825,4543,"zString"
"17332",51,3,102,108,9679434,9683592,4158,"zString"
"17536",51,3,96,109,9725929,9730160,4231,"zString"
"17736",51,2,175,110,9735244,9740227,4983,"zString"
"17832",51,3,99,111,9742463,9746327,3864,"zString"
"18039",51,2,176,112,9751244,9756294,5050,"zString"
"18140",51,3,117,113,9759609,9763777,4168,"zString"
"18241",51,2,173,114,9767968,9772328,4360,"zString"
"18330",51,2,160,115,9775228,9780728,5500,"zString"
"18533",51,2,174,116,9789650,9795364,5714,"zString"
"18635",51,3,91,117,9800336,9805900,5564,"zString"
"18815",51,2,163,118,9854523,9859581,5058,"zString"
"18945",51,2,169,119,9861746,9866931,5185,"zString"
"19023",51,3,111,120,9869241,9872231,2990,"zString"
"19155",51,2,167,121,9874343,9878598,4255,"zString"
"19227",51,3,119,122,9880554,9885548,4994,"zString"
"19343",51,2,154,123,9887494,9893598,6104,"zString"
"19539",51,3,95,124,9897500,9902716,5216,"zString"
"19741",51,3,108,125,9906763,9912732,5969,"zString"
"19834",51,2,162,126,9914593,9918333,3740,"zString"
"20041",51,3,98,127,9922288,9926200,3912,"zString"
"20235",51,3,103,128,9929931,9934767,4836,"zString"
"20331",51,2,165,129,9936645,9940617,3972,"zString"
"20439",51,3,115,130,9942448,9946550,4102,"zString"
"20534",51,3,113,131,9948957,9954601,5644,"zString"
"20639",51,2,170,132,10098041,10102272,4231,"zString"
"20740",51,3,104,133,10104477,10108256,3779,"zString"
"20834",51,3,106,134,10110376,10115123,4747,"zString"
"20940",51,3,94,135,10120056,10124540,4484,"zString"
"21154",51,2,171,136,10131526,10137840,6314,"zString"
"21235",51,2,177,137,10141302,10145592,4290,"zString"
"21337",51,2,168,138,10150639,10155807,5168,"zString"
"21434",51,3,100,139,10159021,10165091,6070,"zString"
"21634",51,3,110,140,10171361,10176892,5531,"zString"
"21738",51,3,118,141,10182372,10188308,5936,"zString"
"21835",51,3,114,142,10214618,10218610,3992,"zString"
"21940",51,3,97,143,10222047,10225461,3414,"zString"
"22154",51,2,180,144,10229922,10234344,4422,"zString"
"22240",51,3,116,145,10238191,10243497,5306,"zString"
"22339",51,2,166,146,10246281,10250913,4632,"zString"
"22438",51,3,105,147,10252638,10257578,4940,"zString"
"22537",51,3,93,148,10259761,10263614,3853,"zString"
"22734",51,3,107,149,10269059,10275428,6369,"zString"
"22839",51,2,179,150,10277268,10282801,5533,"zString"
"22938",51,1,129,151,10288643,10294716,6073,"zString"
"23158",51,1,125,152,10300135,10304467,4332,"zString"
"23340",51,1,142,153,10310290,10315167,4877,"zString"
"23441",51,1,138,154,10318073,10322030,3957,"zString"
"23533",51,1,127,155,10326296,10330818,4522,"zString"
"23734",51,1,139,156,10335648,10340531,4883,"zString"
"23837",51,1,150,157,10342365,10346797,4432,"zString"
"23933",51,1,123,158,10348887,10353281,4394,"zString"
"24146",51,1,133,159,10358178,10363531,5353,"zString"
"24237",51,1,136,160,10365542,10370882,5340,"zString"
"24340",51,1,149,161,10373300,10378165,4865,"zString"
"24435",51,1,124,162,10380174,10387715,7541,"zString"
"24636",51,1,122,163,10391786,10396633,4847,"zString"
"24836",51,1,147,164,10400715,10406833,6118,"zString"
"24936",51,1,145,165,10408594,10413216,4622,"zString"
"25037",51,1,128,166,10416352,10421233,4881,"zString"
"25238",51,1,140,167,10425182,10430183,5001,"zString"
"25334",51,1,121,168,10431762,10436534,4772,"zString"
"25537",51,1,141,169,10440496,10444551,4055,"zString"
"25635",51,1,148,170,10446682,10451501,4819,"zString"
"25742",51,1,146,171,10453495,10459401,5906,"zString"
"25836",51,1,137,172,10461323,10467968,6645,"zString"
"25934",51,1,134,173,10470014,10476135,6121,"zString"
"26040",51,1,130,174,10478284,10482885,4601,"zString"
"26240",51,1,144,175,10487084,10492852,5768,"zString"
"26336",51,1,135,176,10494800,10500803,6003,"zString"
"26432",51,1,143,177,10502735,10507936,5201,"zString"
"26534",51,1,132,178,10509911,10516336,6425,"zString"
"26735",51,1,131,179,10520668,10526037,5369,"zString"
"26932",51,1,126,180,10530598,10536254,5656,"zString"
"10163",52,2,31,1,1350081,1353545,3464,"zString"
"12155",52,2,32,2,1358686,1362479,3793,"zString"
"1450",52,2,33,3,1366358,1369396,3038,"zString"
"16153",52,2,60,4,1373609,1376596,2987,"zString"
"17150",52,3,63,5,1379075,1381829,2754,"zString"
"19156",52,3,71,6,1386173,1389513,3340,"zString"
"21155",52,3,61,7,1393251,1396247,2996,"zString"
"23159",52,3,81,8,1400484,1402314,1830,"zString"
"24147",52,3,87,9,1404502,1407831,3329,"zString"
"25146",52,2,52,10,1409533,1413131,3598,"zString"
"26145",52,3,66,11,1415175,1417381,2206,"zString"
"2830",52,3,62,12,1421497,1423648,2151,"zString"
"3038",52,2,44,13,1429381,1432331,2950,"zString"
"3140",52,2,43,14,1433764,1437015,3251,"zString"
"3238",52,3,72,15,1438414,1441532,3118,"zString"
"3433",52,3,77,16,1445904,1447982,2078,"zString"
"3541",52,3,73,17,1449813,1451549,1736,"zString"
"3631",52,3,64,18,1453320,1456948,3628,"zString"
"3833",52,2,34,19,1461425,1463566,2141,"zString"
"4035",52,3,80,20,1467471,1470799,3328,"zString"
"4140",52,2,45,21,1473392,1475449,2057,"zString"
"4236",52,2,59,22,1477053,1480150,3097,"zString"
"4341",52,2,49,23,1482117,1484816,2699,"zString"
"4435",52,3,70,24,1486718,1489167,2449,"zString"
"4631",52,2,56,25,1493506,1497167,3661,"zString"
"4739",52,2,50,26,1498733,1502050,3317,"zString"
"4831",52,2,38,27,1503754,1505817,2063,"zString"
"5035",52,2,48,28,1509938,1513317,3379,"zString"
"5131",52,2,35,29,1515291,1517901,2610,"zString"
"5324",52,3,82,30,1521793,1524668,2875,"zString"
"5439",52,3,85,31,1526684,1530701,4017,"zString"
"5521",52,2,57,32,1532571,1534868,2297,"zString"
"5639",52,3,90,33,1536396,1538752,2356,"zString"
"5722",52,2,46,34,1540573,1542652,2079,"zString"
"5840",52,2,58,35,1546071,1548619,2548,"zString"
"5937",52,3,67,36,1550447,1552935,2488,"zString"
"6137",52,3,89,37,1556942,1559519,2577,"zString"
"6230",52,2,55,38,1561191,1563919,2728,"zString"
"6339",52,2,40,39,1565743,1569803,4060,"zString"
"6537",52,3,86,40,1574108,1576769,2661,"zString"
"6638",52,2,54,41,1579460,1582119,2659,"zString"
"6737",52,2,41,42,1745935,1748492,2557,"zString"
"6939",52,3,88,43,1753249,1755392,2143,"zString"
"7039",52,2,53,44,1757019,1760109,3090,"zString"
"7138",52,2,39,45,1762258,1764793,2535,"zString"
"7337",52,2,51,46,1769546,1771710,2164,"zString"
"7437",52,3,83,47,1775159,1777393,2234,"zString"
"7540",52,3,84,48,1778913,1781793,2880,"zString"
"7638",52,2,36,49,1783796,1787093,3297,"zString"
"7835",52,3,78,50,1792141,1795177,3036,"zString"
"7941",52,2,47,51,1796873,1799977,3104,"zString"
"8035",52,3,75,52,1801629,1804594,2965,"zString"
"8134",52,2,37,53,1806150,1808094,1944,"zString"
"8341",52,3,74,54,1812366,1816011,3645,"zString"
"8438",52,3,65,55,1818044,1820445,2401,"zString"
"8635",52,3,68,56,1824169,1827661,3492,"zString"
"8837",52,3,79,57,1831915,1835278,3363,"zString"
"8940",52,3,69,58,1836819,1839328,2509,"zString"
"9144",52,3,76,59,1843170,1846512,3342,"zString"
"9233",52,2,42,60,1848015,1851212,3197,"zString"
"9443",52,1,15,61,1855382,1858763,3381,"zString"
"9542",52,1,8,62,1861423,1864979,3556,"zString"
"9737",52,1,1,63,1870434,1872363,1929,"zString"
"9938",52,1,29,64,1876179,1878496,2317,"zString"
"10034",52,1,7,65,1881142,1884630,3488,"zString"
"10243",52,1,16,66,1888652,1892447,3795,"zString"
"10335",52,1,9,67,1894812,1897580,2768,"zString"
"10537",52,1,13,68,1901803,1904381,2578,"zString"
"10639",52,1,18,69,1906652,1908881,2229,"zString"
"10733",52,1,28,70,1911163,1914398,3235,"zString"
"10840",52,1,11,71,1917648,1920365,2717,"zString"
"11035",52,1,24,72,1924143,1928015,3872,"zString"
"11140",52,1,21,73,1929851,1931882,2031,"zString"
"11233",52,1,30,74,1934539,1937282,2743,"zString"
"11339",52,1,17,75,1939047,1940815,1768,"zString"
"11434",52,1,6,76,1942788,1944499,1711,"zString"
"11637",52,1,25,77,1948874,1950349,1475,"zString"
"11734",52,1,5,78,1952441,1954152,1711,"zString"
"11934",52,1,4,79,1958620,1961349,2729,"zString"
"12156",52,1,3,80,1965563,1968466,2903,"zString"
"12338",52,1,12,81,1972350,1975516,3166,"zString"
"12535",52,1,14,82,1979246,1981200,1954,"zString"
"12638",52,1,10,83,1982803,1984700,1897,"zString"
"12837",52,1,2,84,1989521,1991367,1846,"zString"
"13041",52,1,26,85,1996318,1998817,2499,"zString"
"13133",52,1,19,86,2000209,2003251,3042,"zString"
"13240",52,1,22,87,2004847,2007851,3004,"zString"
"13341",52,1,20,88,2009447,2011718,2271,"zString"
"13434",52,1,27,89,2013451,2016134,2683,"zString"
"13535",52,1,23,90,2018168,2021101,2933,"zString"
"14542",52,2,121,91,2247233,2252076,4843,"reading"
"14741",52,2,122,92,2260448,2264093,3645,"reading"
"14941",52,2,123,93,2270074,2274427,4353,"reading"
"15142",52,2,147,94,2280700,2285177,4477,"reading"
"15238",52,2,131,95,2286946,2290260,3314,"reading"
"15436",52,3,174,96,2297371,2301461,4090,"reading"
"15539",52,2,128,97,2303480,2308578,5098,"reading"
"15735",52,2,132,98,2316881,2320878,3997,"reading"
"15938",52,3,162,99,2326315,2330012,3697,"reading"
"16154",52,2,135,100,2336135,2339879,3744,"reading"
"16240",52,2,127,101,2341600,2345262,3662,"reading"
"16442",52,2,125,102,2350996,2354446,3450,"reading"
"16637",52,3,160,103,2358790,2362763,3973,"reading"
"16836",52,3,163,104,2367679,2371580,3901,"reading"
"16938",52,2,149,105,2373499,2377613,4114,"reading"
"17036",52,2,143,106,2379270,2382397,3127,"reading"
"17151",52,3,155,107,2384321,2389064,4743,"reading"
"17333",52,2,144,108,2396138,2401214,5076,"reading"
"17436",52,2,138,109,2402998,2407731,4733,"reading"
"17537",52,3,164,110,2409281,2414115,4834,"reading"
"17636",52,3,157,111,2416185,2420965,4780,"reading"
"17833",52,2,150,112,2425785,2429349,3564,"reading"
"17938",52,3,153,113,2431114,2434182,3068,"reading"
"18141",52,2,145,114,2438322,2441066,2744,"reading"
"18242",52,3,154,115,2443109,2447316,4207,"reading"
"18436",52,3,158,116,2452264,2456466,4202,"reading"
"18636",52,3,151,117,2463283,2467950,4667,"reading"
"18816",52,2,134,118,2473968,2478000,4032,"reading"
"18946",52,2,124,119,2479529,2482351,2822,"reading"
"19157",52,3,159,120,2486868,2489951,3083,"reading"
"19344",52,3,169,121,2494987,2499234,4247,"reading"
"19433",52,3,175,122,2501417,2504084,2667,"reading"
"19540",52,3,180,123,2506469,2509435,2966,"reading"
"19635",52,3,167,124,2511122,2514918,3796,"reading"
"19742",52,3,168,125,2516647,2519985,3338,"reading"
"19835",52,3,165,126,2522221,2525452,3231,"reading"
"19935",52,2,142,127,2528047,2531969,3922,"reading"
"20042",52,2,136,128,2534047,2537702,3655,"reading"
"20144",52,3,177,129,2539832,2544052,4220,"reading"
"20236",52,2,126,130,2545562,2548036,2474,"reading"
"20440",52,3,170,131,2553543,2556670,3127,"reading"
"20535",52,2,140,132,2716313,2720625,4312,"reading"
"20640",52,3,173,133,2722630,2727425,4795,"reading"
"20741",52,2,141,134,2729102,2733459,4357,"reading"
"20835",52,3,176,135,2735325,2739842,4517,"reading"
"20941",52,2,139,136,2742157,2745242,3085,"reading"
"21034",52,3,178,137,2747224,2751659,4435,"reading"
"21156",52,3,156,138,2753228,2756276,3048,"reading"
"21338",52,2,133,139,2762049,2765660,3611,"reading"
"21435",52,2,146,140,2767252,2770693,3441,"reading"
"21535",52,3,161,141,2772298,2776160,3862,"reading"
"21739",52,3,166,142,2784615,2788994,4379,"reading"
"21836",52,3,172,143,2791090,2793894,2804,"reading"
"21941",52,2,130,144,2795523,2799311,3788,"reading"
"22155",52,3,171,145,2803578,2806578,3000,"reading"
"22241",52,3,179,146,2808759,2811678,2919,"reading"
"22340",52,2,129,147,2814047,2816262,2215,"reading"
"22538",52,2,148,148,2821291,2824095,2804,"reading"
"22632",52,2,137,149,2825886,2828062,2176,"reading"
"22735",52,3,152,150,2829856,2833245,3389,"reading"
"22939",52,1,120,151,2841183,2844946,3763,"reading"
"23033",52,1,112,152,2846418,2850063,3645,"reading"
"23160",52,1,104,153,2851666,2855113,3447,"reading"
"23234",52,1,103,154,2857123,2859897,2774,"reading"
"23341",52,1,97,155,2861576,2864313,2737,"reading"
"23534",52,1,119,156,2869834,2873397,3563,"reading"
"23634",52,1,114,157,2875025,2878814,3789,"reading"
"23735",52,1,108,158,2880886,2883897,3011,"reading"
"23838",52,1,117,159,2885556,2888864,3308,"reading"
"23934",52,1,106,160,2890539,2894281,3742,"reading"
"24036",52,1,96,161,2895859,2897998,2139,"reading"
"24238",52,1,107,162,2903982,2907681,3699,"reading"
"24341",52,1,91,163,2909306,2913432,4126,"reading"
"24540",52,1,101,164,2921689,2925932,4243,"reading"
"24735",52,1,116,165,2930263,2932849,2586,"reading"
"24837",52,1,92,166,2934637,2937082,2445,"reading"
"25038",52,1,100,167,2942332,2944799,2467,"reading"
"25239",52,1,113,168,2948651,2951700,3049,"reading"
"25335",52,1,93,169,2953220,2956683,3463,"reading"
"25538",52,1,115,170,2962687,2966167,3480,"reading"
"25636",52,1,109,171,2967897,2970450,2553,"reading"
"25743",52,1,95,172,2972636,2975767,3131,"reading"
"25935",52,1,105,173,2980965,2984100,3135,"reading"
"26041",52,1,98,174,2985845,2989901,4056,"reading"
"26241",52,1,118,175,2996881,3000301,3420,"reading"
"26337",52,1,94,176,3001893,3004851,2958,"reading"
"26535",52,1,110,177,3010866,3013285,2419,"reading"
"26634",52,1,99,178,3014910,3017618,2708,"reading"
"26839",52,1,102,179,3026304,3028969,2665,"reading"
"27041",52,1,111,180,3034597,3038319,3722,"reading"
"10164",53,1,76,1,5104429,5106989,2560,"reading"
"11101",53,1,79,2,5108899,5113173,4274,"reading"
"12157",53,1,73,3,5114610,5117756,3146,"reading"
"1376",53,1,85,4,5119155,5124223,5068,"reading"
"1460",53,1,84,5,5126088,5129807,3719,"reading"
"15107",53,1,70,6,5131909,5134973,3064,"reading"
"17152",53,1,67,7,5140670,5143157,2487,"reading"
"19158",53,1,81,8,5150919,5156691,5772,"reading"
"20145",53,1,64,9,5158649,5162541,3892,"reading"
"22156",53,1,69,10,5169421,5173925,4504,"reading"
"24148",53,1,71,11,5179804,5182425,2621,"reading"
"26146",53,1,88,12,5188898,5191909,3011,"reading"
"2758",53,1,75,13,5193583,5196409,2826,"reading"
"2831",53,1,77,14,5199222,5202026,2804,"reading"
"2941",53,1,80,15,5203400,5206242,2842,"reading"
"3039",53,1,72,16,5207935,5211543,3608,"reading"
"3239",53,1,90,17,5218572,5223160,4588,"reading"
"3340",53,1,61,18,5225589,5231077,5488,"reading"
"3542",53,1,83,19,5236421,5238944,2523,"reading"
"3632",53,1,89,20,5240808,5243894,3086,"reading"
"3744",53,1,78,21,5245874,5251427,5553,"reading"
"3834",53,1,63,22,5253011,5260644,7633,"reading"
"4036",53,1,82,23,5266258,5269395,3137,"reading"
"4141",53,1,65,24,5270947,5274695,3748,"reading"
"4342",53,1,62,25,5280034,5284345,4311,"reading"
"4542",53,1,86,26,5288977,5294146,5169,"reading"
"4632",53,1,68,27,5295920,5302162,6242,"reading"
"4832",53,1,87,28,5308572,5313679,5107,"reading"
"4939",53,1,66,29,5316474,5319480,3006,"reading"
"5132",53,1,74,30,5324178,5326880,2702,"reading"
"5243",53,2,1,31,5329984,5335664,5680,"reading"
"5440",53,2,2,32,5340430,5347197,6767,"reading"
"5640",53,2,3,33,5352407,5356431,4024,"reading"
"5841",53,3,44,34,5361411,5365681,4270,"reading"
"5938",53,3,55,35,5367594,5371815,4221,"reading"
"6039",53,2,13,36,5373792,5376898,3106,"reading"
"6138",53,2,10,37,5379027,5381432,2405,"reading"
"6340",53,3,58,38,5385919,5390099,4180,"reading"
"6436",53,3,50,39,5392013,5394849,2836,"reading"
"6538",53,2,21,40,5396736,5400849,4113,"reading"
"6639",53,2,17,41,5402701,5407166,4465,"reading"
"6738",53,2,22,42,5560899,5563971,3072,"reading"
"6839",53,2,18,43,5565510,5568705,3195,"reading"
"6940",53,3,48,44,5570341,5574272,3931,"reading"
"7040",53,3,53,45,5576192,5580939,4747,"reading"
"7139",53,2,30,46,5582468,5586189,3721,"reading"
"7237",53,2,19,47,5587978,5590905,2927,"reading"
"7338",53,2,14,48,5592547,5598456,5909,"reading"
"7438",53,2,12,49,5600085,5602723,2638,"reading"
"7639",53,2,8,50,5607686,5611090,3404,"reading"
"7836",53,2,9,51,5616625,5620040,3415,"reading"
"8036",53,2,7,52,5625007,5629223,4216,"reading"
"8235",53,3,35,53,5634180,5638240,4060,"reading"
"8439",53,2,28,54,5643236,5645641,2405,"reading"
"8536",53,3,54,55,5647817,5653041,5224,"reading"
"8636",53,3,41,56,5654854,5656891,2037,"reading"
"8838",53,2,6,57,5661813,5665892,4079,"reading"
"9038",53,3,43,58,5671708,5674542,2834,"reading"
"9145",53,2,26,59,5676423,5679692,3269,"reading"
"9234",53,3,33,60,5681592,5688809,7217,"reading"
"9444",53,2,15,61,5693897,5697809,3912,"reading"
"9543",53,3,31,62,5699265,5704576,5311,"reading"
"9738",53,3,56,63,5709672,5712493,2821,"reading"
"9839",53,2,4,64,5714203,5718427,4224,"reading"
"10035",53,3,37,65,5724390,5730693,6303,"reading"
"10244",53,3,57,66,5735756,5739777,4021,"reading"
"10336",53,2,29,67,5741273,5745628,4355,"reading"
"10436",53,3,39,68,5747552,5752878,5326,"reading"
"10640",53,3,59,69,5757725,5759911,2186,"reading"
"10734",53,3,51,70,5761662,5766345,4683,"reading"
"10841",53,3,49,71,5769027,5773678,4651,"reading"
"10932",53,3,60,72,5775348,5778195,2847,"reading"
"11036",53,3,34,73,5779903,5782629,2726,"reading"
"11234",53,2,11,74,5787420,5791362,3942,"reading"
"11435",53,3,47,75,5796548,5802429,5881,"reading"
"11529",53,3,32,76,5804292,5806679,2387,"reading"
"11735",53,2,23,77,5812254,5815496,3242,"reading"
"11835",53,3,45,78,5817198,5821947,4749,"reading"
"11935",53,3,36,79,5823793,5825897,2104,"reading"
"12158",53,3,46,80,5831166,5838864,7698,"reading"
"12232",53,3,40,81,5841654,5843997,2343,"reading"
"12436",53,2,24,82,5849471,5853598,4127,"reading"
"12536",53,3,52,83,5855481,5861548,6067,"reading"
"12639",53,2,20,84,5863561,5866798,3237,"reading"
"12739",53,2,16,85,5868265,5871049,2784,"reading"
"12838",53,3,38,86,5872815,5875632,2817,"reading"
"13042",53,2,5,87,5881526,5885249,3723,"reading"
"13241",53,3,42,88,5889775,5896216,6441,"reading"
"13435",53,2,27,89,5903081,5906750,3669,"reading"
"13536",53,2,25,90,5908493,5911650,3157,"reading"
"14543",53,1,167,91,6259704,6264095,4391,"zString"
"14615",53,1,174,92,6266222,6269645,3423,"zString"
"14742",53,1,177,93,6271186,6274012,2826,"zString"
"14824",53,1,173,94,6276932,6279662,2730,"zString"
"14942",53,1,160,95,6281583,6284446,2863,"zString"
"15143",53,1,156,96,6288128,6291146,3018,"zString"
"15333",53,1,172,97,6294626,6298280,3654,"zString"
"15437",53,1,152,98,6300028,6303213,3185,"zString"
"15638",53,1,166,99,6307055,6309697,2642,"zString"
"15736",53,1,171,100,6311827,6314930,3103,"zString"
"15833",53,1,178,101,6316509,6319247,2738,"zString"
"15939",53,1,161,102,6321201,6324364,3163,"zString"
"16155",53,1,162,103,6328043,6330564,2521,"zString"
"16333",53,1,164,104,6334973,6338081,3108,"zString"
"16443",53,1,163,105,6340073,6343514,3441,"zString"
"16537",53,1,157,106,6345567,6348765,3198,"zString"
"16737",53,1,165,107,6353714,6357215,3501,"zString"
"16837",53,1,176,108,6359084,6363315,4231,"zString"
"16939",53,1,170,109,6364805,6368499,3694,"zString"
"17037",53,1,169,110,6370277,6374099,3822,"zString"
"17153",53,1,153,111,6376329,6379083,2754,"zString"
"17334",53,1,179,112,6383294,6386549,3255,"zString"
"17437",53,1,168,113,6388276,6391666,3390,"zString"
"17538",53,1,180,114,6393343,6396450,3107,"zString"
"17637",53,1,158,115,6398282,6401083,2801,"zString"
"17834",53,1,154,116,6405005,6407467,2462,"zString"
"18040",53,1,155,117,6412337,6415317,2980,"zString"
"18243",53,1,175,118,6418898,6422284,3386,"zString"
"18331",53,1,159,119,6423853,6426884,3031,"zString"
"18534",53,1,151,120,6432087,6434934,2847,"zString"
"18743",53,2,91,121,6438354,6441318,2964,"zString"
"18947",53,2,92,122,6445851,6448785,2934,"zString"
"19159",53,2,93,123,6454029,6457102,3073,"zString"
"19345",53,2,117,124,6461326,6463485,2159,"zString"
"19434",53,3,142,125,6466777,6468969,2192,"zString"
"19541",53,2,108,126,6472119,6476386,4267,"zString"
"19636",53,3,141,127,6478650,6480686,2036,"zString"
"19743",53,3,136,128,6482752,6485670,2918,"zString"
"19836",53,3,145,129,6487233,6489719,2486,"zString"
"19936",53,3,129,130,6492420,6495420,3000,"zString"
"20146",53,2,112,131,6500060,6503553,3493,"zString"
"20237",53,3,124,132,6654575,6657992,3417,"zString"
"20441",53,3,127,133,6661746,6664592,2846,"zString"
"20641",53,2,119,134,6669795,6673442,3647,"zString"
"20742",53,2,120,135,6675230,6678059,2829,"zString"
"20836",53,2,118,136,6680096,6682443,2347,"zString"
"20942",53,2,105,137,6685503,6687526,2023,"zString"
"21035",53,3,123,138,6689042,6691776,2734,"zString"
"21236",53,3,146,139,6696494,6699827,3333,"zString"
"21339",53,2,102,140,6701395,6703827,2432,"zString"
"21536",53,3,134,141,6707302,6710111,2809,"zString"
"21635",53,3,130,142,6712096,6714460,2364,"zString"
"21837",53,3,121,143,6719454,6722627,3173,"zString"
"22035",53,3,131,144,6727370,6729578,2208,"zString"
"22242",53,2,95,145,6734477,6736861,2384,"zString"
"22439",53,3,133,146,6740820,6743345,2525,"zString"
"22539",53,3,122,147,6745563,6748145,2582,"zString"
"22736",53,2,115,148,6751802,6754112,2310,"zString"
"22840",53,2,114,149,6756343,6758479,2136,"zString"
"22940",53,3,126,150,6759819,6762245,2426,"zString"
"23161",53,3,144,151,6766348,6768979,2631,"zString"
"23235",53,2,113,152,6770995,6772746,1751,"zString"
"23342",53,2,110,153,6774752,6777079,2327,"zString"
"23442",53,3,135,154,6778822,6782313,3491,"zString"
"23535",53,3,125,155,6784449,6787146,2697,"zString"
"23736",53,3,147,156,6791233,6794063,2830,"zString"
"23839",53,2,97,157,6796325,6797813,1488,"zString"
"24037",53,2,101,158,6801987,6803914,1927,"zString"
"24239",53,3,132,159,6809250,6812097,2847,"zString"
"24436",53,2,98,160,6815956,6819581,3625,"zString"
"24637",53,2,109,161,6823156,6825348,2192,"zString"
"24736",53,3,138,162,6828580,6830614,2034,"zString"
"24838",53,3,137,163,6833802,6835948,2146,"zString"
"24937",53,2,103,164,6837903,6840115,2212,"zString"
"25039",53,2,106,165,6841872,6844165,2293,"zString"
"25147",53,2,99,166,6846576,6849532,2956,"zString"
"25336",53,3,149,167,6852994,6855216,2222,"zString"
"25435",53,2,116,168,6857416,6860899,3483,"zString"
"25539",53,2,111,169,6862927,6865949,3022,"zString"
"25637",53,2,100,170,6868340,6871416,3076,"zString"
"25837",53,3,139,171,6875165,6877800,2635,"zString"
"25936",53,3,143,172,6879725,6882400,2675,"zString"
"26042",53,2,96,173,6884034,6887133,3099,"zString"
"26242",53,3,150,174,6891169,6895800,4631,"zString"
"26338",53,3,148,175,6897607,6902150,4543,"zString"
"26433",53,2,104,176,6904205,6909784,5579,"zString"
"26536",53,2,107,177,6912845,6916734,3889,"zString"
"26635",53,2,94,178,6919779,6922268,2489,"zString"
"26840",53,3,140,179,6926628,6931201,4573,"zString"
"26933",53,3,128,180,6934036,6938335,4299,"zString"
"10165",54,1,52,1,8667110,8670977,3867,"zString"
"11102",54,1,54,2,8672618,8675727,3109,"zString"
"12159",54,1,57,3,8678419,8681344,2925,"zString"
"1377",54,1,55,4,8683627,8686444,2817,"zString"
"1470",54,1,38,5,8688160,8692744,4584,"zString"
"16156",54,1,43,6,8699412,8703145,3733,"zString"
"17154",54,1,41,7,8707789,8710445,2656,"zString"
"19160",54,1,33,8,8715450,8717762,2312,"zString"
"21157",54,1,56,9,8721203,8724879,3676,"zString"
"22157",54,1,35,10,8726883,8729596,2713,"zString"
"24149",54,1,51,11,8735064,8738113,3049,"zString"
"25148",54,1,45,12,8740686,8743679,2993,"zString"
"26147",54,1,36,13,8747388,8750613,3225,"zString"
"2832",54,1,47,14,8754216,8758363,4147,"zString"
"2942",54,1,31,15,8765926,8769747,3821,"zString"
"3141",54,1,34,16,8774110,8777114,3004,"zString"
"3341",54,1,59,17,8781784,8784814,3030,"zString"
"3434",54,1,49,18,8787080,8789548,2468,"zString"
"3543",54,1,50,19,8791475,8794031,2556,"zString"
"3633",54,1,37,20,8796225,8799198,2973,"zString"
"3835",54,1,40,21,8805812,8809632,3820,"zString"
"4037",54,1,42,22,8815451,8818782,3331,"zString"
"4237",54,1,60,23,8822995,8826016,3021,"zString"
"4343",54,1,39,24,8828073,8831316,3243,"zString"
"4543",54,1,44,25,8834908,8837433,2525,"zString"
"4633",54,1,32,26,8839260,8842449,3189,"zString"
"4833",54,1,48,27,8847008,8850316,3308,"zString"
"4940",54,1,46,28,8852340,8860633,8293,"zString"
"5036",54,1,53,29,8863779,8867883,4104,"zString"
"5133",54,1,58,30,8869593,8874684,5091,"zString"
"5244",54,2,61,31,8876616,8881317,4701,"zString"
"5441",54,2,62,32,8885233,8889601,4368,"zString"
"5641",54,2,63,33,8893828,8896818,2990,"zString"
"5842",54,2,89,34,8900625,8903368,2743,"zString"
"5939",54,3,11,35,8907375,8910785,3410,"zString"
"6139",54,2,73,36,8918080,8920935,2855,"zString"
"6231",54,3,20,37,8923119,8926169,3050,"zString"
"6341",54,3,14,38,8927827,8930352,2525,"zString"
"6437",54,2,86,39,8932081,8934803,2722,"zString"
"6539",54,3,22,40,8940144,8943036,2892,"zString"
"6640",54,2,85,41,8945964,8950270,4306,"zString"
"6739",54,2,76,42,9100293,9104842,4549,"zString"
"6840",54,2,69,43,9106563,9109525,2962,"zString"
"7041",54,2,88,44,9114647,9117375,2728,"zString"
"7140",54,2,64,45,9119057,9121575,2518,"zString"
"7339",54,2,66,46,9127734,9131376,3642,"zString"
"7541",54,3,30,47,9135379,9139259,3880,"zString"
"7640",54,2,65,48,9141099,9144460,3361,"zString"
"7837",54,3,28,49,9152926,9155643,2717,"zString"
"7942",54,3,10,50,9157462,9159810,2348,"zString"
"8135",54,3,9,51,9165426,9167844,2418,"zString"
"8342",54,3,15,52,9171888,9175411,3523,"zString"
"8440",54,3,4,53,9177924,9180611,2687,"zString"
"8637",54,2,71,54,9185588,9189812,4224,"zString"
"8839",54,3,25,55,9194393,9197378,2985,"zString"
"8941",54,2,77,56,9198925,9201712,2787,"zString"
"9039",54,3,6,57,9203219,9206262,3043,"zString"
"9235",54,3,21,58,9210626,9213945,3319,"zString"
"9336",54,3,8,59,9215487,9218812,3325,"zString"
"9544",54,2,75,60,9223436,9226379,2943,"zString"
"9635",54,2,83,61,9228508,9231563,3055,"zString"
"9739",54,2,90,62,9234136,9236296,2160,"zString"
"9840",54,3,7,63,9238671,9240963,2292,"zString"
"10166",54,2,80,65,9270742,9274631,3889,"zString"
"10245",54,2,67,66,9276250,9278514,2264,"zString"
"10437",54,2,82,67,9282949,9285731,2782,"zString"
"10538",54,2,74,68,9287460,9290698,3238,"zString"
"10641",54,3,26,69,9292057,9294731,2674,"zString"
"10735",54,3,3,70,9296978,9299498,2520,"zString"
"10933",54,2,78,71,9303954,9307665,3711,"zString"
"11141",54,3,18,73,9330153,9332916,2763,"zString"
"11235",54,3,17,74,9337724,9341083,3359,"zString"
"11340",54,3,1,75,9343404,9345500,2096,"zString"
"11530",54,2,81,76,9349046,9351500,2454,"zString"
"11638",54,3,12,77,9353226,9355300,2074,"zString"
"11836",54,2,79,78,9360655,9363400,2745,"zString"
"11936",54,3,16,79,9365739,9368501,2762,"zString"
"12043",54,3,23,80,9370268,9373034,2766,"zString"
"12160",54,3,27,81,9374848,9377218,2370,"zString"
"12233",54,3,5,82,9381197,9383485,2288,"zString"
"12437",54,2,70,83,9388644,9390985,2341,"zString"
"12640",54,2,68,84,9396892,9400552,3660,"zString"
"12839",54,3,29,85,9404355,9406752,2397,"zString"
"12932",54,3,13,86,9410148,9412369,2221,"zString"
"13043",54,3,19,87,9414360,9417052,2692,"zString"
"13134",54,2,84,88,9418655,9421886,3231,"zString"
"13242",54,2,87,89,9423786,9426919,3133,"zString"
"13342",54,3,24,90,9430764,9433370,2606,"zString"
"13436",54,2,72,91,9437389,9439819,2430,"zString"
"13612",54,3,2,92,9445381,9450053,4672,"zString"
"14743",54,1,123,93,9657888,9660860,2972,"reading"
"14943",54,1,149,94,9665980,9672594,6614,"reading"
"15020",54,1,132,95,9675104,9679711,4607,"reading"
"15239",54,1,134,96,9685929,9689561,3632,"reading"
"15334",54,1,144,97,9693370,9698412,5042,"reading"
"15438",54,1,150,98,9703925,9707662,3737,"reading"
"15540",54,1,121,99,9711578,9716429,4851,"reading"
"15737",54,1,130,100,9722320,9726513,4193,"reading"
"15940",54,1,147,101,9732916,9737129,4213,"reading"
"16033",54,1,137,102,9740216,9743446,3230,"reading"
"16157",54,1,127,103,9748090,9751680,3590,"reading"
"16334",54,1,145,104,9759435,9762997,3562,"reading"
"16444",54,1,138,105,9766077,9769947,3870,"reading"
"16538",54,1,126,106,9771793,9775097,3304,"reading"
"16738",54,1,136,107,9782343,9787015,4672,"reading"
"16838",54,1,128,108,9789728,9793898,4170,"reading"
"17038",54,1,142,109,9799965,9804215,4250,"reading"
"17155",54,1,141,110,9808504,9813732,5228,"reading"
"17240",54,1,125,111,9817606,9821299,3693,"reading"
"17438",54,1,139,112,9828085,9830999,2914,"reading"
"17539",54,1,146,113,9835446,9839152,3706,"reading"
"17638",54,1,122,114,9869656,9873451,3795,"reading"
"17835",54,1,129,115,9880899,9884685,3786,"reading"
"18041",54,1,124,116,9890151,9893618,3467,"reading"
"18244",54,1,131,117,9901799,9905052,3253,"reading"
"18437",54,1,135,118,9913368,9917369,4001,"reading"
"18535",54,1,133,119,9934895,9939337,4442,"reading"
"18637",54,1,148,120,9941658,9944803,3145,"reading"
"18744",54,1,143,121,9947509,9951954,4445,"reading"
"18817",54,1,140,122,9955893,9959054,3161,"reading"
"18948",54,2,151,123,9961981,9967654,5673,"reading"
"19161",54,2,152,124,9973865,9978471,4606,"reading"
"19346",54,2,153,125,9984536,9987888,3352,"reading"
"19542",54,3,111,126,10045453,10049557,4104,"reading"
"19637",54,3,112,127,10051636,10055074,3438,"reading"
"19744",54,2,165,128,10057735,10062074,4339,"reading"
"19837",54,2,161,129,10066194,10069791,3597,"reading"
"20043",54,3,93,130,10076108,10078774,2666,"reading"
"20238",54,2,166,131,10083221,10087691,4470,"reading"
"20332",54,3,103,132,10091988,10095692,3704,"reading"
"20442",54,2,169,133,10098405,10102159,3754,"reading"
"20536",54,3,98,134,10246732,10251264,4532,"reading"
"20743",54,2,156,135,10258715,10262248,3533,"reading"
"20943",54,2,180,136,10267596,10271114,3518,"reading"
"21036",54,3,110,137,10273411,10279198,5787,"reading"
"21158",54,3,119,138,10281178,10285465,4287,"reading"
"21237",54,3,107,139,10290369,10295532,5163,"reading"
"21340",54,3,117,140,10298037,10301499,3462,"reading"
"21436",54,2,154,141,10303803,10308233,4430,"reading"
"21636",54,3,108,142,10313274,10316999,3725,"reading"
"21740",54,3,100,143,10318899,10322521,3622,"reading"
"21942",54,2,157,144,10327636,10331534,3898,"reading"
"22158",54,2,175,145,10338522,10342317,3795,"reading"
"22243",54,2,177,146,10346708,10350584,3876,"reading"
"22341",54,3,115,147,10352746,10355201,2455,"reading"
"22440",54,3,105,148,10357330,10360401,3071,"reading"
"22540",54,3,118,149,10362375,10365351,2976,"reading"
"22633",54,3,102,150,10367956,10370501,2545,"reading"
"22841",54,3,101,151,10377012,10379985,2973,"reading"
"23034",54,2,179,152,10385285,10388435,3150,"reading"
"23162",54,2,160,153,10390889,10395085,4196,"reading"
"23343",54,3,106,154,10402070,10406219,4149,"reading"
"23443",54,2,164,155,10408902,10413320,4418,"reading"
"23536",54,2,173,156,10415187,10418269,3082,"reading"
"23635",54,3,97,157,10421084,10424119,3035,"reading"
"23840",54,3,92,158,10429326,10433303,3977,"reading"
"24038",54,3,120,159,10438572,10442337,3765,"reading"
"24150",54,2,158,160,10445410,10448754,3344,"reading"
"24342",54,2,176,161,10453557,10456671,3114,"reading"
"24437",54,3,94,162,10459319,10462404,3085,"reading"
"24638",54,2,178,163,10469763,10473005,3242,"reading"
"24737",54,2,174,164,10477489,10481288,3799,"reading"
"24839",54,2,159,165,10484574,10489122,4548,"reading"
"25040",54,2,163,166,10495105,10499372,4267,"reading"
"25149",54,2,170,167,10501764,10505422,3658,"reading"
"25240",54,2,172,168,10507959,10511706,3747,"reading"
"25337",54,2,168,169,10513956,10517273,3317,"reading"
"25436",54,2,155,170,10520116,10523873,3757,"reading"
"25638",54,3,113,171,10530140,10533223,3083,"reading"
"25744",54,2,167,172,10535911,10539223,3312,"reading"
"25838",54,3,99,173,10542209,10546507,4298,"reading"
"26043",54,3,96,174,10553328,10556141,2813,"reading"
"26243",54,3,104,175,10563079,10566008,2929,"reading"
"26339",54,3,114,176,10567811,10571974,4163,"reading"
"26434",54,2,162,177,10574198,10577491,3293,"reading"
"26636",54,3,95,178,10582562,10586925,4363,"reading"
"26841",54,3,116,179,10592712,10595959,3247,"reading"
"26934",54,3,91,180,10598076,10601625,3549,"reading"
"27115",54,2,171,181,10607504,10610476,2972,"reading"
"27213",54,3,109,182,10614512,10617376,2864,"reading"
